TCGGGGCTTTC: CGGGGCTTTCA
CGGGGCTTTCA: GGGGCTTTCAG
GGGGCTTTCAG: GGGCTTTCAGC
GGGCTTTCAGC: GGCTTTCAGCT
GGCTTTCAGCT: GCTTTCAGCTC
GCTTTCAGCTC: CTTTCAGCTCT
CTTTCAGCTCT: TTTCAGCTCTA
TTTCAGCTCTA: TTCAGCTCTAG
TTCAGCTCTAG: TCAGCTCTAGG
TCAGCTCTAGG: CAGCTCTAGGG
CAGCTCTAGGG: AGCTCTAGGGA
AGCTCTAGGGA: GCTCTAGGGAT
GCTCTAGGGAT: CTCTAGGGATG
CTCTAGGGATG: TCTAGGGATGA
TCTAGGGATGA: CTAGGGATGAT
CTAGGGATGAT: TAGGGATGATG
TAGGGATGATG: AGGGATGATGG
AGGGATGATGG: GGGATGATGGA
GGGATGATGGA: GGATGATGGAA
GGATGATGGAA: GATGATGGAAC
GATGATGGAAC: ATGATGGAACC
ATGATGGAACC: TGATGGAACCT
TGATGGAACCT: GATGGAACCTT
GATGGAACCTT: ATGGAACCTTG
ATGGAACCTTG: TGGAACCTTGG
TGGAACCTTGG: GGAACCTTGGG
GGAACCTTGGG: GAACCTTGGGT
GAACCTTGGGT: AACCTTGGGTT
AACCTTGGGTT: ACCTTGGGTTA
ACCTTGGGTTA: CCTTGGGTTAA
CCTTGGGTTAA: CTTGGGTTAAG
CTTGGGTTAAG: TTGGGTTAAGT
TTGGGTTAAGT: TGGGTTAAGTG
TGGGTTAAGTG: GGGTTAAGTGG
GGGTTAAGTGG: GGTTAAGTGGT
GGTTAAGTGGT: GTTAAGTGGTA
GTTAAGTGGTA: TTAAGTGGTAG
TTAAGTGGTAG: TAAGTGGTAGG
TAAGTGGTAGG: AAGTGGTAGGT
AAGTGGTAGGT: AGTGGTAGGTT
AGTGGTAGGTT: GTGGTAGGTTC
GTGGTAGGTTC: TGGTAGGTTCT
TGGTAGGTTCT: GGTAGGTTCTG
GGTAGGTTCTG: GTAGGTTCTGA
GTAGGTTCTGA: TAGGTTCTGAG
TAGGTTCTGAG: AGGTTCTGAGA
AGGTTCTGAGA: GGTTCTGAGAG
GGTTCTGAGAG: GTTCTGAGAGA
GTTCTGAGAGA: TTCTGAGAGAC
TTCTGAGAGAC: TCTGAGAGACG
TCTGAGAGACG: CTGAGAGACGA
CTGAGAGACGA: TGAGAGACGAG
TGAGAGACGAG: GAGAGACGAGT
GAGAGACGAGT: AGAGACGAGTC
AGAGACGAGTC: GAGACGAGTCT
GAGACGAGTCT: AGACGAGTCTA
AGACGAGTCTA: GACGAGTCTAA
GACGAGTCTAA: ACGAGTCTAAA
ACGAGTCTAAA: CGAGTCTAAAA
CGAGTCTAAAA: GAGTCTAAAAA
GAGTCTAAAAA: AGTCTAAAAAT
AGTCTAAAAAT: GTCTAAAAATC
GTCTAAAAATC: TCTAAAAATCA
TCTAAAAATCA: CTAAAAATCAC
CTAAAAATCAC: TAAAAATCACT
TAAAAATCACT: AAAAATCACTA
AAAAATCACTA: AAAATCACTAG
AAAATCACTAG: AAATCACTAGA
AAATCACTAGA: AATCACTAGAA
AATCACTAGAA: ATCACTAGAAC
ATCACTAGAAC: TCACTAGAACT
TCACTAGAACT: CACTAGAACTG
CACTAGAACTG: ACTAGAACTGT
ACTAGAACTGT: CTAGAACTGTA
CTAGAACTGTA: TAGAACTGTAG
TAGAACTGTAG: AGAACTGTAGA
AGAACTGTAGA: GAACTGTAGAA
GAACTGTAGAA: AACTGTAGAAA
AACTGTAGAAA: ACTGTAGAAAG
ACTGTAGAAAG: CTGTAGAAAGA
CTGTAGAAAGA: TGTAGAAAGAT
TGTAGAAAGAT: GTAGAAAGATC
GTAGAAAGATC: TAGAAAGATCG
TAGAAAGATCG: AGAAAGATCGG
AGAAAGATCGG: GAAAGATCGGA
GAAAGATCGGA: AAAGATCGGAC
AAAGATCGGAC: AAGATCGGACC
AAGATCGGACC: AGATCGGACCT
AGATCGGACCT: GATCGGACCTT
GATCGGACCTT: ATCGGACCTTT
ATCGGACCTTT: TCGGACCTTTG
TCGGACCTTTG: CGGACCTTTGC
CGGACCTTTGC: GGACCTTTGCA
GGACCTTTGCA: GACCTTTGCAT
GACCTTTGCAT: ACCTTTGCATC
ACCTTTGCATC: CCTTTGCATCA
CCTTTGCATCA: CTTTGCATCAG
CTTTGCATCAG: TTTGCATCAGT
TTTGCATCAGT: TTGCATCAGTA
TTGCATCAGTA: TGCATCAGTAG
TGCATCAGTAG: GCATCAGTAGT
GCATCAGTAGT: CATCAGTAGTC
CATCAGTAGTC: ATCAGTAGTCA
ATCAGTAGTCA: TCAGTAGTCAT
TCAGTAGTCAT: CAGTAGTCATG
CAGTAGTCATG: AGTAGTCATGT
AGTAGTCATGT: GTAGTCATGTT
GTAGTCATGTT: TAGTCATGTTC
TAGTCATGTTC: AGTCATGTTCG
AGTCATGTTCG: GTCATGTTCGG
GTCATGTTCGG: TCATGTTCGGG
TCATGTTCGGG: CATGTTCGGGC
CATGTTCGGGC: ATGTTCGGGCC
ATGTTCGGGCC: TGTTCGGGCCG
TGTTCGGGCCG: GTTCGGGCCGC
GTTCGGGCCGC: TTCGGGCCGCC
TTCGGGCCGCC: TCGGGCCGCCT
TCGGGCCGCCT: CGGGCCGCCTG
CGGGCCGCCTG: GGGCCGCCTGT
GGGCCGCCTGT: GGCCGCCTGTA
GGCCGCCTGTA: GCCGCCTGTAA
GCCGCCTGTAA: CCGCCTGTAAC
CCGCCTGTAAC: CGCCTGTAACT
CGCCTGTAACT: GCCTGTAACTA
GCCTGTAACTA: CCTGTAACTAA
CCTGTAACTAA: CTGTAACTAAC
CTGTAACTAAC: TGTAACTAACG
TGTAACTAACG: GTAACTAACGC
GTAACTAACGC: TAACTAACGCG
TAACTAACGCG: AACTAACGCGT
AACTAACGCGT: ACTAACGCGTT
ACTAACGCGTT: CTAACGCGTTA
CTAACGCGTTA: TAACGCGTTAA
TAACGCGTTAA: AACGCGTTAAC
AACGCGTTAAC: ACGCGTTAACT
ACGCGTTAACT: CGCGTTAACTA
CGCGTTAACTA: GCGTTAACTAC
GCGTTAACTAC: CGTTAACTACG
CGTTAACTACG: GTTAACTACGC
GTTAACTACGC: TTAACTACGCA
TTAACTACGCA: TAACTACGCAT
TAACTACGCAT: AACTACGCATA
AACTACGCATA: ACTACGCATAT
ACTACGCATAT: CTACGCATATC
CTACGCATATC: TACGCATATCT
TACGCATATCT: ACGCATATCTG
ACGCATATCTG: CGCATATCTGG
CGCATATCTGG: GCATATCTGGG
GCATATCTGGG: CATATCTGGGT
CATATCTGGGT: ATATCTGGGTC
ATATCTGGGTC: TATCTGGGTCT
TATCTGGGTCT: ATCTGGGTCTT
ATCTGGGTCTT: TCTGGGTCTTA
TCTGGGTCTTA: CTGGGTCTTAC
CTGGGTCTTAC: TGGGTCTTACT
TGGGTCTTACT: GGGTCTTACTT
GGGTCTTACTT: GGTCTTACTTT
GGTCTTACTTT: GTCTTACTTTT
GTCTTACTTTT: TCTTACTTTTA
TCTTACTTTTA: CTTACTTTTAT
CTTACTTTTAT: TTACTTTTATT
TTACTTTTATT: TACTTTTATTA
TACTTTTATTA: ACTTTTATTAC
ACTTTTATTAC: CTTTTATTACA
CTTTTATTACA: TTTTATTACAT
TTTTATTACAT: TTTATTACATA
TTTATTACATA: TTATTACATAG
TTATTACATAG: TATTACATAGG
TATTACATAGG: ATTACATAGGC
ATTACATAGGC: TTACATAGGCG
TTACATAGGCG: TACATAGGCGA
TACATAGGCGA: ACATAGGCGAT
ACATAGGCGAT: CATAGGCGATA
CATAGGCGATA: ATAGGCGATAA
ATAGGCGATAA: TAGGCGATAAA
TAGGCGATAAA: AGGCGATAAAC
AGGCGATAAAC: GGCGATAAACA
GGCGATAAACA: GCGATAAACAG
GCGATAAACAG: CGATAAACAGC
CGATAAACAGC: GATAAACAGCA
GATAAACAGCA: ATAAACAGCAG
ATAAACAGCAG: TAAACAGCAGC
TAAACAGCAGC: AAACAGCAGCA
AAACAGCAGCA: AACAGCAGCAA
AACAGCAGCAA: ACAGCAGCAAC
ACAGCAGCAAC: CAGCAGCAACA
CAGCAGCAACA: AGCAGCAACAC
AGCAGCAACAC: GCAGCAACACC
GCAGCAACACC: CAGCAACACCC
CAGCAACACCC: AGCAACACCCG
AGCAACACCCG: GCAACACCCGT
GCAACACCCGT: CAACACCCGTC
CAACACCCGTC: AACACCCGTCT
AACACCCGTCT: ACACCCGTCTC
ACACCCGTCTC: CACCCGTCTCG
CACCCGTCTCG: ACCCGTCTCGT
ACCCGTCTCGT: CCCGTCTCGTG
CCCGTCTCGTG: CCGTCTCGTGT
CCGTCTCGTGT: CGTCTCGTGTT
CGTCTCGTGTT: GTCTCGTGTTC
GTCTCGTGTTC: TCTCGTGTTCG
TCTCGTGTTCG: CTCGTGTTCGA
CTCGTGTTCGA: TCGTGTTCGAA
TCGTGTTCGAA: CGTGTTCGAAA
CGTGTTCGAAA: GTGTTCGAAAG
GTGTTCGAAAG: TGTTCGAAAGG
TGTTCGAAAGG: GTTCGAAAGGT
GTTCGAAAGGT: TTCGAAAGGTG
TTCGAAAGGTG: TCGAAAGGTGG
TCGAAAGGTGG: CGAAAGGTGGG
CGAAAGGTGGG: GAAAGGTGGGA
GAAAGGTGGGA: AAAGGTGGGAA
AAAGGTGGGAA: AAGGTGGGAAT
AAGGTGGGAAT: AGGTGGGAATC
AGGTGGGAATC: GGTGGGAATCC
GGTGGGAATCC: GTGGGAATCCC
GTGGGAATCCC: TGGGAATCCCC
TGGGAATCCCC: GGGAATCCCCA
GGGAATCCCCA: GGAATCCCCAT
GGAATCCCCAT: GAATCCCCATT
GAATCCCCATT: AATCCCCATTG
AATCCCCATTG: ATCCCCATTGA
ATCCCCATTGA: TCCCCATTGAC
TCCCCATTGAC: CCCCATTGACT
CCCCATTGACT: CCCATTGACTT
CCCATTGACTT: CCATTGACTTT
CCATTGACTTT: CATTGACTTTT
CATTGACTTTT: ATTGACTTTTT
ATTGACTTTTT: TTGACTTTTTT
TTGACTTTTTT: TGACTTTTTTG
TGACTTTTTTG: GACTTTTTTGT
GACTTTTTTGT: ACTTTTTTGTG
ACTTTTTTGTG: CTTTTTTGTGC
CTTTTTTGTGC: TTTTTTGTGCT
TTTTTTGTGCT: TTTTTGTGCTC
TTTTTGTGCTC: TTTTGTGCTCG
TTTTGTGCTCG: TTTGTGCTCGT
TTTGTGCTCGT: TTGTGCTCGTG
TTGTGCTCGTG: TGTGCTCGTGG
TGTGCTCGTGG: GTGCTCGTGGA
GTGCTCGTGGA: TGCTCGTGGAT
TGCTCGTGGAT: GCTCGTGGATT
GCTCGTGGATT: CTCGTGGATTT
CTCGTGGATTT: TCGTGGATTTA
TCGTGGATTTA: CGTGGATTTAG
CGTGGATTTAG: GTGGATTTAGA
GTGGATTTAGA: TGGATTTAGAC
TGGATTTAGAC: GGATTTAGACG
GGATTTAGACG: GATTTAGACGA
GATTTAGACGA: ATTTAGACGAG
ATTTAGACGAG: TTTAGACGAGA
TTTAGACGAGA: TTAGACGAGAA
TTAGACGAGAA: TAGACGAGAAG
TAGACGAGAAG: AGACGAGAAGG
AGACGAGAAGG: GACGAGAAGGA
GACGAGAAGGA: ACGAGAAGGAT
ACGAGAAGGAT: CGAGAAGGATG
CGAGAAGGATG: GAGAAGGATGC
GAGAAGGATGC: AGAAGGATGCC
AGAAGGATGCC: GAAGGATGCCG
GAAGGATGCCG: AAGGATGCCGG
AAGGATGCCGG: AGGATGCCGGT
AGGATGCCGGT: GGATGCCGGTG
GGATGCCGGTG: GATGCCGGTGG
GATGCCGGTGG: ATGCCGGTGGA
ATGCCGGTGGA: TGCCGGTGGAC
TGCCGGTGGAC: GCCGGTGGACG
GCCGGTGGACG: CCGGTGGACGC
CCGGTGGACGC: CGGTGGACGCG
CGGTGGACGCG: GGTGGACGCGT
GGTGGACGCGT: GTGGACGCGTC
GTGGACGCGTC: TGGACGCGTCT
TGGACGCGTCT: GGACGCGTCTA
GGACGCGTCTA: GACGCGTCTAG
GACGCGTCTAG: ACGCGTCTAGT
ACGCGTCTAGT: CGCGTCTAGTC
CGCGTCTAGTC: GCGTCTAGTCA
GCGTCTAGTCA: CGTCTAGTCAA
CGTCTAGTCAA: GTCTAGTCAAA
GTCTAGTCAAA: TCTAGTCAAAA
TCTAGTCAAAA: CTAGTCAAAAT
CTAGTCAAAAT: TAGTCAAAATT
TAGTCAAAATT: AGTCAAAATTG
AGTCAAAATTG: GTCAAAATTGC
GTCAAAATTGC: TCAAAATTGCG
TCAAAATTGCG: CAAAATTGCGT
CAAAATTGCGT: AAAATTGCGTG
AAAATTGCGTG: AAATTGCGTGG
AAATTGCGTGG: AATTGCGTGGG
AATTGCGTGGG: ATTGCGTGGGA
ATTGCGTGGGA: TTGCGTGGGAC
TTGCGTGGGAC: TGCGTGGGACC
TGCGTGGGACC: GCGTGGGACCT
GCGTGGGACCT: CGTGGGACCTC
CGTGGGACCTC: GTGGGACCTCG
GTGGGACCTCG: TGGGACCTCGG
TGGGACCTCGG: GGGACCTCGGC
GGGACCTCGGC: GGACCTCGGCC
GGACCTCGGCC: GACCTCGGCCT
GACCTCGGCCT: ACCTCGGCCTT
ACCTCGGCCTT: CCTCGGCCTTA
CCTCGGCCTTA: CTCGGCCTTAG
CTCGGCCTTAG: TCGGCCTTAGT
TCGGCCTTAGT: CGGCCTTAGTT
CGGCCTTAGTT: GGCCTTAGTTT
GGCCTTAGTTT: GCCTTAGTTTC
GCCTTAGTTTC: CCTTAGTTTCG
CCTTAGTTTCG: CTTAGTTTCGA
CTTAGTTTCGA: TTAGTTTCGAC
TTAGTTTCGAC: TAGTTTCGACT
TAGTTTCGACT: AGTTTCGACTA
AGTTTCGACTA: GTTTCGACTAT
GTTTCGACTAT: TTTCGACTATG
TTTCGACTATG: TTCGACTATGA
TTCGACTATGA: TCGACTATGAC
TCGACTATGAC: CGACTATGACA
CGACTATGACA: GACTATGACAT
GACTATGACAT: ACTATGACATA
ACTATGACATA: CTATGACATAC
CTATGACATAC: TATGACATACG
TATGACATACG: ATGACATACGG
ATGACATACGG: TGACATACGGG
TGACATACGGG: GACATACGGGA
GACATACGGGA: ACATACGGGAC
ACATACGGGAC: CATACGGGACA
CATACGGGACA: ATACGGGACAA
ATACGGGACAA: TACGGGACAAA
TACGGGACAAA: ACGGGACAAAG
ACGGGACAAAG: CGGGACAAAGC
CGGGACAAAGC: GGGACAAAGCC
GGGACAAAGCC: GGACAAAGCCC
GGACAAAGCCC: GACAAAGCCCG
GACAAAGCCCG: ACAAAGCCCGT
ACAAAGCCCGT: CAAAGCCCGTG
CAAAGCCCGTG: AAAGCCCGTGT
AAAGCCCGTGT: AAGCCCGTGTG
AAGCCCGTGTG: AGCCCGTGTGG
AGCCCGTGTGG: GCCCGTGTGGA
GCCCGTGTGGA: CCCGTGTGGAG
CCCGTGTGGAG: CCGTGTGGAGG
CCGTGTGGAGG: CGTGTGGAGGG
CGTGTGGAGGG: GTGTGGAGGGT
GTGTGGAGGGT: TGTGGAGGGTC
TGTGGAGGGTC: GTGGAGGGTCG
GTGGAGGGTCG: TGGAGGGTCGT
TGGAGGGTCGT: GGAGGGTCGTG
GGAGGGTCGTG: GAGGGTCGTGA
GAGGGTCGTGA: AGGGTCGTGAC
AGGGTCGTGAC: GGGTCGTGACT
GGGTCGTGACT: GGTCGTGACTT
GGTCGTGACTT: GTCGTGACTTT
GTCGTGACTTT: TCGTGACTTTC
TCGTGACTTTC: CGTGACTTTCC
CGTGACTTTCC: GTGACTTTCCA
GTGACTTTCCA: TGACTTTCCAA
TGACTTTCCAA: GACTTTCCAAC
GACTTTCCAAC: ACTTTCCAACA
ACTTTCCAACA: CTTTCCAACAT
CTTTCCAACAT: TTTCCAACATT
TTTCCAACATT: TTCCAACATTC
TTCCAACATTC: TCCAACATTCG
TCCAACATTCG: CCAACATTCGC
CCAACATTCGC: CAACATTCGCC
CAACATTCGCC: AACATTCGCCA
AACATTCGCCA: ACATTCGCCAG
ACATTCGCCAG: CATTCGCCAGG
CATTCGCCAGG: ATTCGCCAGGG
ATTCGCCAGGG: TTCGCCAGGGC
TTCGCCAGGGC: TCGCCAGGGCG
TCGCCAGGGCG: CGCCAGGGCGG
CGCCAGGGCGG: GCCAGGGCGGC
GCCAGGGCGGC: CCAGGGCGGCG
CCAGGGCGGCG: CAGGGCGGCGC
CAGGGCGGCGC: AGGGCGGCGCC
AGGGCGGCGCC: GGGCGGCGCCT
GGGCGGCGCCT: GGCGGCGCCTA
GGCGGCGCCTA: GCGGCGCCTAT
GCGGCGCCTAT: CGGCGCCTATG
CGGCGCCTATG: GGCGCCTATGT
GGCGCCTATGT: GCGCCTATGTT
GCGCCTATGTT: CGCCTATGTTC
CGCCTATGTTC: GCCTATGTTCA
GCCTATGTTCA: CCTATGTTCAG
CCTATGTTCAG: CTATGTTCAGC
CTATGTTCAGC: TATGTTCAGCG
TATGTTCAGCG: ATGTTCAGCGG
ATGTTCAGCGG: TGTTCAGCGGG
TGTTCAGCGGG: GTTCAGCGGGT
GTTCAGCGGGT: TTCAGCGGGTA
TTCAGCGGGTA: TCAGCGGGTAT
TCAGCGGGTAT: CAGCGGGTATT
CAGCGGGTATT: AGCGGGTATTG
AGCGGGTATTG: GCGGGTATTGC
GCGGGTATTGC: CGGGTATTGCG
CGGGTATTGCG: GGGTATTGCGT
GGGTATTGCGT: GGTATTGCGTA
GGTATTGCGTA: GTATTGCGTAT
GTATTGCGTAT: TATTGCGTATT
TATTGCGTATT: ATTGCGTATTA
ATTGCGTATTA: TTGCGTATTAT
TTGCGTATTAT: TGCGTATTATG
TGCGTATTATG: GCGTATTATGT
GCGTATTATGT: CGTATTATGTC
CGTATTATGTC: GTATTATGTCT
GTATTATGTCT: TATTATGTCTG
TATTATGTCTG: ATTATGTCTGA
ATTATGTCTGA: TTATGTCTGAT
TTATGTCTGAT: TATGTCTGATT
TATGTCTGATT: ATGTCTGATTC
ATGTCTGATTC: TGTCTGATTCC
TGTCTGATTCC: GTCTGATTCCC
GTCTGATTCCC: TCTGATTCCCT
TCTGATTCCCT: CTGATTCCCTA
CTGATTCCCTA: TGATTCCCTAG
TGATTCCCTAG: GATTCCCTAGA
GATTCCCTAGA: ATTCCCTAGAC
ATTCCCTAGAC: TTCCCTAGACA
TTCCCTAGACA: TCCCTAGACAT
TCCCTAGACAT: CCCTAGACATA
CCCTAGACATA: CCTAGACATAG
CCTAGACATAG: CTAGACATAGA
CTAGACATAGA: TAGACATAGAC
TAGACATAGAC: AGACATAGACT
AGACATAGACT: GACATAGACTA
GACATAGACTA: ACATAGACTAT
ACATAGACTAT: CATAGACTATT
CATAGACTATT: ATAGACTATTA
ATAGACTATTA: TAGACTATTAT
TAGACTATTAT: AGACTATTATT
AGACTATTATT: GACTATTATTC
GACTATTATTC: ACTATTATTCT
ACTATTATTCT: CTATTATTCTT
CTATTATTCTT: TATTATTCTTG
TATTATTCTTG: ATTATTCTTGG
ATTATTCTTGG: TTATTCTTGGC
TTATTCTTGGC: TATTCTTGGCA
TATTCTTGGCA: ATTCTTGGCAC
ATTCTTGGCAC: TTCTTGGCACC
TTCTTGGCACC: TCTTGGCACCC
TCTTGGCACCC: CTTGGCACCCC
CTTGGCACCCC: TTGGCACCCCT
TTGGCACCCCT: TGGCACCCCTG
TGGCACCCCTG: GGCACCCCTGA
GGCACCCCTGA: GCACCCCTGAT
GCACCCCTGAT: CACCCCTGATC
CACCCCTGATC: ACCCCTGATCC
ACCCCTGATCC: CCCCTGATCCA
CCCCTGATCCA: CCCTGATCCAC
CCCTGATCCAC: CCTGATCCACG
CCTGATCCACG: CTGATCCACGA
CTGATCCACGA: TGATCCACGAG
TGATCCACGAG: GATCCACGAGG
GATCCACGAGG: ATCCACGAGGG
ATCCACGAGGG: TCCACGAGGGA
TCCACGAGGGA: CCACGAGGGAT
CCACGAGGGAT: CACGAGGGATT
CACGAGGGATT: ACGAGGGATTT
ACGAGGGATTT: CGAGGGATTTC
CGAGGGATTTC: GAGGGATTTCG
GAGGGATTTCG: AGGGATTTCGA
AGGGATTTCGA: GGGATTTCGAC
GGGATTTCGAC: GGATTTCGACG
GGATTTCGACG: GATTTCGACGA
GATTTCGACGA: ATTTCGACGAT
ATTTCGACGAT: TTTCGACGATG
TTTCGACGATG: TTCGACGATGT
TTCGACGATGT: TCGACGATGTG
TCGACGATGTG: CGACGATGTGC
CGACGATGTGC: GACGATGTGCA
GACGATGTGCA: ACGATGTGCAT
ACGATGTGCAT: CGATGTGCATC
CGATGTGCATC: GATGTGCATCG
GATGTGCATCG: ATGTGCATCGA
ATGTGCATCGA: TGTGCATCGAC
TGTGCATCGAC: GTGCATCGACT
GTGCATCGACT: TGCATCGACTT
TGCATCGACTT: GCATCGACTTT
GCATCGACTTT: CATCGACTTTT
CATCGACTTTT: ATCGACTTTTC
ATCGACTTTTC: TCGACTTTTCG
TCGACTTTTCG: CGACTTTTCGC
CGACTTTTCGC: GACTTTTCGCC
GACTTTTCGCC: ACTTTTCGCCA
ACTTTTCGCCA: CTTTTCGCCAT
CTTTTCGCCAT: TTTTCGCCATA
TTTTCGCCATA: TTTCGCCATAT
TTTCGCCATAT: TTCGCCATATG
TTCGCCATATG: TCGCCATATGT
TCGCCATATGT: CGCCATATGTG
CGCCATATGTG: GCCATATGTGT
GCCATATGTGT: CCATATGTGTC
CCATATGTGTC: CATATGTGTCG
CATATGTGTCG: ATATGTGTCGT
ATATGTGTCGT: TATGTGTCGTG
TATGTGTCGTG: ATGTGTCGTGG
ATGTGTCGTGG: TGTGTCGTGGA
TGTGTCGTGGA: GTGTCGTGGAC
GTGTCGTGGAC: TGTCGTGGACC
TGTCGTGGACC: GTCGTGGACCA
GTCGTGGACCA: TCGTGGACCAG
TCGTGGACCAG: CGTGGACCAGG
CGTGGACCAGG: GTGGACCAGGG
GTGGACCAGGG: TGGACCAGGGG
TGGACCAGGGG: GGACCAGGGGT
GGACCAGGGGT: GACCAGGGGTT
GACCAGGGGTT: ACCAGGGGTTA
ACCAGGGGTTA: CCAGGGGTTAG
CCAGGGGTTAG: CAGGGGTTAGG
CAGGGGTTAGG: AGGGGTTAGGG
AGGGGTTAGGG: GGGGTTAGGGC
GGGGTTAGGGC: GGGTTAGGGCG
GGGTTAGGGCG: GGTTAGGGCGA
GGTTAGGGCGA: GTTAGGGCGAA
GTTAGGGCGAA: TTAGGGCGAAG
TTAGGGCGAAG: TAGGGCGAAGA
TAGGGCGAAGA: AGGGCGAAGAA
AGGGCGAAGAA: GGGCGAAGAAG
GGGCGAAGAAG: GGCGAAGAAGC
GGCGAAGAAGC: GCGAAGAAGCG GCGAAGAAGCC
GCGAAGAAGCG: CGAAGAAGCGC
CGAAGAAGCGC: GAAGAAGCGCC
GAAGAAGCGCC: AAGAAGCGCCA
AAGAAGCGCCA: AGAAGCGCCAT
AGAAGCGCCAT: GAAGCGCCATT
GAAGCGCCATT: AAGCGCCATTT
AAGCGCCATTT: AGCGCCATTTA
AGCGCCATTTA: GCGCCATTTAA
GCGCCATTTAA: CGCCATTTAAG
CGCCATTTAAG: GCCATTTAAGG
GCCATTTAAGG: CCATTTAAGGC
CCATTTAAGGC: CATTTAAGGCA
CATTTAAGGCA: ATTTAAGGCAA
ATTTAAGGCAA: TTTAAGGCAAC
TTTAAGGCAAC: TTAAGGCAACT
TTAAGGCAACT: TAAGGCAACTA
TAAGGCAACTA: AAGGCAACTAA
AAGGCAACTAA: AGGCAACTAAA
AGGCAACTAAA: GGCAACTAAAT
GGCAACTAAAT: GCAACTAAATT
GCAACTAAATT: CAACTAAATTA
CAACTAAATTA: AACTAAATTAC
AACTAAATTAC: ACTAAATTACG
ACTAAATTACG: CTAAATTACGA
CTAAATTACGA: TAAATTACGAT
TAAATTACGAT: AAATTACGATG
AAATTACGATG: AATTACGATGC
AATTACGATGC: ATTACGATGCT
ATTACGATGCT: TTACGATGCTG
TTACGATGCTG: TACGATGCTGT
TACGATGCTGT: ACGATGCTGTT
ACGATGCTGTT: CGATGCTGTTC
CGATGCTGTTC: GATGCTGTTCT
GATGCTGTTCT: ATGCTGTTCTG
ATGCTGTTCTG: TGCTGTTCTGG
TGCTGTTCTGG: GCTGTTCTGGA
GCTGTTCTGGA: CTGTTCTGGAG
CTGTTCTGGAG: TGTTCTGGAGG
TGTTCTGGAGG: GTTCTGGAGGA
GTTCTGGAGGA: TTCTGGAGGAT
TTCTGGAGGAT: TCTGGAGGATT
TCTGGAGGATT: CTGGAGGATTT
CTGGAGGATTT: TGGAGGATTTA
TGGAGGATTTA: GGAGGATTTAA
GGAGGATTTAA: GAGGATTTAAG
GAGGATTTAAG: AGGATTTAAGT
AGGATTTAAGT: GGATTTAAGTA
GGATTTAAGTA: GATTTAAGTAA
GATTTAAGTAA: ATTTAAGTAAA
ATTTAAGTAAA: TTTAAGTAAAC
TTTAAGTAAAC: TTAAGTAAACA
TTAAGTAAACA: TAAGTAAACAT
TAAGTAAACAT: AAGTAAACATG
AAGTAAACATG: AGTAAACATGC
AGTAAACATGC: GTAAACATGCA
GTAAACATGCA: TAAACATGCAC
TAAACATGCAC: AAACATGCACA
AAACATGCACA: AACATGCACAT
AACATGCACAT: ACATGCACATC
ACATGCACATC: CATGCACATCG
CATGCACATCG: ATGCACATCGC
ATGCACATCGC: TGCACATCGCG
TGCACATCGCG: GCACATCGCGG
GCACATCGCGG: CACATCGCGGT
CACATCGCGGT: ACATCGCGGTG
ACATCGCGGTG: CATCGCGGTGG
CATCGCGGTGG: ATCGCGGTGGT
ATCGCGGTGGT: TCGCGGTGGTG
TCGCGGTGGTG: CGCGGTGGTGA
CGCGGTGGTGA: GCGGTGGTGAG
GCGGTGGTGAG: CGGTGGTGAGG
CGGTGGTGAGG: GGTGGTGAGGA
GGTGGTGAGGA: GTGGTGAGGAC
GTGGTGAGGAC: TGGTGAGGACT
TGGTGAGGACT: GGTGAGGACTT
GGTGAGGACTT: GTGAGGACTTG
GTGAGGACTTG: TGAGGACTTGG
TGAGGACTTGG: GAGGACTTGGT
GAGGACTTGGT: AGGACTTGGTC
AGGACTTGGTC: GGACTTGGTCG
GGACTTGGTCG: GACTTGGTCGT
GACTTGGTCGT: ACTTGGTCGTA
ACTTGGTCGTA: CTTGGTCGTAT
CTTGGTCGTAT: TTGGTCGTATC
TTGGTCGTATC: TGGTCGTATCC
TGGTCGTATCC: GGTCGTATCCT
GGTCGTATCCT: GTCGTATCCTT
GTCGTATCCTT: TCGTATCCTTT
TCGTATCCTTT: CGTATCCTTTC
CGTATCCTTTC: GTATCCTTTCC
GTATCCTTTCC: TATCCTTTCCA
TATCCTTTCCA: ATCCTTTCCAC
ATCCTTTCCAC: TCCTTTCCACA
TCCTTTCCACA: CCTTTCCACAA
CCTTTCCACAA: CTTTCCACAAG
CTTTCCACAAG: TTTCCACAAGG
TTTCCACAAGG: TTCCACAAGGT
TTCCACAAGGT: TCCACAAGGTC
TCCACAAGGTC: CCACAAGGTCC
CCACAAGGTCC: CACAAGGTCCT
CACAAGGTCCT: ACAAGGTCCTT
ACAAGGTCCTT: CAAGGTCCTTG
CAAGGTCCTTG: AAGGTCCTTGA
AAGGTCCTTGA: AGGTCCTTGAG
AGGTCCTTGAG: GGTCCTTGAGG
GGTCCTTGAGG: GTCCTTGAGGA
GTCCTTGAGGA: TCCTTGAGGAG
TCCTTGAGGAG: CCTTGAGGAGG
CCTTGAGGAGG: CTTGAGGAGGG
CTTGAGGAGGG: TTGAGGAGGGC
TTGAGGAGGGC: TGAGGAGGGCC
TGAGGAGGGCC: GAGGAGGGCCG
GAGGAGGGCCG: AGGAGGGCCGT
AGGAGGGCCGT: GGAGGGCCGTT
GGAGGGCCGTT: GAGGGCCGTTC
GAGGGCCGTTC: AGGGCCGTTCG
AGGGCCGTTCG: GGGCCGTTCGC
GGGCCGTTCGC: GGCCGTTCGCT
GGCCGTTCGCT: GCCGTTCGCTA
GCCGTTCGCTA: CCGTTCGCTAC
CCGTTCGCTAC: CGTTCGCTACT
CGTTCGCTACT: GTTCGCTACTA
GTTCGCTACTA: TTCGCTACTAC
TTCGCTACTAC: TCGCTACTACA
TCGCTACTACA: CGCTACTACAC
CGCTACTACAC: GCTACTACACT
GCTACTACACT: CTACTACACTC
CTACTACACTC: TACTACACTCC
TACTACACTCC: ACTACACTCCA
ACTACACTCCA: CTACACTCCAT
CTACACTCCAT: TACACTCCATA
TACACTCCATA: ACACTCCATAA
ACACTCCATAA: CACTCCATAAT
CACTCCATAAT: ACTCCATAATT
ACTCCATAATT: CTCCATAATTA
CTCCATAATTA: TCCATAATTAC
TCCATAATTAC: CCATAATTACC
CCATAATTACC: CATAATTACCA
CATAATTACCA: ATAATTACCAA
ATAATTACCAA: TAATTACCAAG
TAATTACCAAG: AATTACCAAGT
AATTACCAAGT: ATTACCAAGTT
ATTACCAAGTT: TTACCAAGTTT
TTACCAAGTTT: TACCAAGTTTC
TACCAAGTTTC: ACCAAGTTTCG
ACCAAGTTTCG: CCAAGTTTCGA
CCAAGTTTCGA: CAAGTTTCGAG
CAAGTTTCGAG: AAGTTTCGAGG
AAGTTTCGAGG: AGTTTCGAGGG
AGTTTCGAGGG: GTTTCGAGGGG
GTTTCGAGGGG: TTTCGAGGGGT
TTTCGAGGGGT: TTCGAGGGGTC
TTCGAGGGGTC: TCGAGGGGTCC
TCGAGGGGTCC: CGAGGGGTCCA
CGAGGGGTCCA: GAGGGGTCCAG
GAGGGGTCCAG: AGGGGTCCAGA
AGGGGTCCAGA: GGGGTCCAGAA
GGGGTCCAGAA: GGGTCCAGAAC
GGGTCCAGAAC: GGTCCAGAACG
GGTCCAGAACG: GTCCAGAACGC
GTCCAGAACGC: TCCAGAACGCC
TCCAGAACGCC: CCAGAACGCCG
CCAGAACGCCG: CAGAACGCCGC
CAGAACGCCGC: AGAACGCCGCA
AGAACGCCGCA: GAACGCCGCAT
GAACGCCGCAT: AACGCCGCATG
AACGCCGCATG: ACGCCGCATGA
ACGCCGCATGA: CGCCGCATGAA
CGCCGCATGAA: GCCGCATGAAT
GCCGCATGAAT: CCGCATGAATA
CCGCATGAATA: CGCATGAATAC
CGCATGAATAC: GCATGAATACT
GCATGAATACT: CATGAATACTA
CATGAATACTA: ATGAATACTAT
ATGAATACTAT: TGAATACTATT
TGAATACTATT: GAATACTATTG
GAATACTATTG: AATACTATTGG
AATACTATTGG: ATACTATTGGT
ATACTATTGGT: TACTATTGGTT
TACTATTGGTT: ACTATTGGTTT
ACTATTGGTTT: CTATTGGTTTT
CTATTGGTTTT: TATTGGTTTTT
TATTGGTTTTT: ATTGGTTTTTG
ATTGGTTTTTG: TTGGTTTTTGA
TTGGTTTTTGA: TGGTTTTTGAA
TGGTTTTTGAA: GGTTTTTGAAT
GGTTTTTGAAT: GTTTTTGAATT
GTTTTTGAATT: TTTTTGAATTG
TTTTTGAATTG: TTTTGAATTGA
TTTTGAATTGA: TTTGAATTGAA
TTTGAATTGAA: TTGAATTGAAG
TTGAATTGAAG: TGAATTGAAGT
TGAATTGAAGT: GAATTGAAGTC
GAATTGAAGTC: AATTGAAGTCG
AATTGAAGTCG: ATTGAAGTCGA
ATTGAAGTCGA: TTGAAGTCGAA
TTGAAGTCGAA: TGAAGTCGAAT
TGAAGTCGAAT: GAAGTCGAATC
GAAGTCGAATC: AAGTCGAATCT
AAGTCGAATCT: AGTCGAATCTG
AGTCGAATCTG: GTCGAATCTGT
GTCGAATCTGT: TCGAATCTGTC
TCGAATCTGTC: CGAATCTGTCG
CGAATCTGTCG: GAATCTGTCGC
GAATCTGTCGC: AATCTGTCGCA
AATCTGTCGCA: ATCTGTCGCAT
ATCTGTCGCAT: TCTGTCGCATA
TCTGTCGCATA: CTGTCGCATAT
CTGTCGCATAT: TGTCGCATATA
TGTCGCATATA: GTCGCATATAG
GTCGCATATAG: TCGCATATAGC
TCGCATATAGC: CGCATATAGCT
CGCATATAGCT: GCATATAGCTA
GCATATAGCTA: CATATAGCTAT
CATATAGCTAT: ATATAGCTATA
ATATAGCTATA: TATAGCTATAT
TATAGCTATAT: ATAGCTATATC
ATAGCTATATC: TAGCTATATCC
TAGCTATATCC: AGCTATATCCG
AGCTATATCCG: GCTATATCCGA
GCTATATCCGA: CTATATCCGAA
CTATATCCGAA: TATATCCGAAG
TATATCCGAAG: ATATCCGAAGG
ATATCCGAAGG: TATCCGAAGGT
TATCCGAAGGT: ATCCGAAGGTG
ATCCGAAGGTG: TCCGAAGGTGC
TCCGAAGGTGC: CCGAAGGTGCC
CCGAAGGTGCC: CGAAGGTGCCT
CGAAGGTGCCT: GAAGGTGCCTG
GAAGGTGCCTG: AAGGTGCCTGC
AAGGTGCCTGC: AGGTGCCTGCG
AGGTGCCTGCG: GGTGCCTGCGC
GGTGCCTGCGC: GTGCCTGCGCT
GTGCCTGCGCT: TGCCTGCGCTG
TGCCTGCGCTG: GCCTGCGCTGA
GCCTGCGCTGA: CCTGCGCTGAA
CCTGCGCTGAA: CTGCGCTGAAT
CTGCGCTGAAT: TGCGCTGAATC
TGCGCTGAATC: GCGCTGAATCT
GCGCTGAATCT: CGCTGAATCTT
CGCTGAATCTT: GCTGAATCTTC
GCTGAATCTTC: CTGAATCTTCT
CTGAATCTTCT: TGAATCTTCTA
TGAATCTTCTA: GAATCTTCTAG
GAATCTTCTAG: AATCTTCTAGA
AATCTTCTAGA: ATCTTCTAGAA
ATCTTCTAGAA: TCTTCTAGAAC
TCTTCTAGAAC: CTTCTAGAACC
CTTCTAGAACC: TTCTAGAACCG
TTCTAGAACCG: TCTAGAACCGA
TCTAGAACCGA: CTAGAACCGAC
CTAGAACCGAC: TAGAACCGACC
TAGAACCGACC: AGAACCGACCA
AGAACCGACCA: GAACCGACCAG
GAACCGACCAG: AACCGACCAGG
AACCGACCAGG: ACCGACCAGGA
ACCGACCAGGA: CCGACCAGGAT
CCGACCAGGAT: CGACCAGGATA
CGACCAGGATA: GACCAGGATAA
GACCAGGATAA: ACCAGGATAAC
ACCAGGATAAC: CCAGGATAACG
CCAGGATAACG: CAGGATAACGG
CAGGATAACGG: AGGATAACGGC
AGGATAACGGC: GGATAACGGCG
GGATAACGGCG: GATAACGGCGG
GATAACGGCGG: ATAACGGCGGT
ATAACGGCGGT: TAACGGCGGTC
TAACGGCGGTC: AACGGCGGTCG
AACGGCGGTCG: ACGGCGGTCGG
ACGGCGGTCGG: CGGCGGTCGGG
CGGCGGTCGGG: GGCGGTCGGGT
GGCGGTCGGGT: GCGGTCGGGTT
GCGGTCGGGTT: CGGTCGGGTTT
CGGTCGGGTTT: GGTCGGGTTTC
GGTCGGGTTTC: GTCGGGTTTCA
GTCGGGTTTCA: TCGGGTTTCAT
TCGGGTTTCAT: CGGGTTTCATG
CGGGTTTCATG: GGGTTTCATGA
GGGTTTCATGA: GGTTTCATGAG
GGTTTCATGAG: GTTTCATGAGC
GTTTCATGAGC: TTTCATGAGCT
TTTCATGAGCT: TTCATGAGCTC
TTCATGAGCTC: TCATGAGCTCA
TCATGAGCTCA: CATGAGCTCAG
CATGAGCTCAG: ATGAGCTCAGA
ATGAGCTCAGA: TGAGCTCAGAC
TGAGCTCAGAC: GAGCTCAGACG
GAGCTCAGACG: AGCTCAGACGA
AGCTCAGACGA: GCTCAGACGAT
GCTCAGACGAT: CTCAGACGATG
CTCAGACGATG: TCAGACGATGA
TCAGACGATGA: CAGACGATGAC
CAGACGATGAC: AGACGATGACG
AGACGATGACG: GACGATGACGG
GACGATGACGG: ACGATGACGGG
ACGATGACGGG: CGATGACGGGG
CGATGACGGGG: GATGACGGGGT
GATGACGGGGT: ATGACGGGGTG
ATGACGGGGTG: TGACGGGGTGC
TGACGGGGTGC: GACGGGGTGCT
GACGGGGTGCT: ACGGGGTGCTA
ACGGGGTGCTA: CGGGGTGCTAC
CGGGGTGCTAC: GGGGTGCTACA
GGGGTGCTACA: GGGTGCTACAG
GGGTGCTACAG: GGTGCTACAGA
GGTGCTACAGA: GTGCTACAGAA
GTGCTACAGAA: TGCTACAGAAA
TGCTACAGAAA: GCTACAGAAAC
GCTACAGAAAC: CTACAGAAACG
CTACAGAAACG: TACAGAAACGG
TACAGAAACGG: ACAGAAACGGG
ACAGAAACGGG: CAGAAACGGGG
CAGAAACGGGG: AGAAACGGGGC
AGAAACGGGGC: GAAACGGGGCT
GAAACGGGGCT: AAACGGGGCTT
AAACGGGGCTT: AACGGGGCTTC
AACGGGGCTTC: ACGGGGCTTCT
ACGGGGCTTCT: CGGGGCTTCTA
CGGGGCTTCTA: GGGGCTTCTAG
GGGGCTTCTAG: GGGCTTCTAGA
GGGCTTCTAGA: GGCTTCTAGAA
GGCTTCTAGAA: GCTTCTAGAAT
GCTTCTAGAAT: CTTCTAGAATC
CTTCTAGAATC: TTCTAGAATCA
TTCTAGAATCA: TCTAGAATCAG
TCTAGAATCAG: CTAGAATCAGC
CTAGAATCAGC: TAGAATCAGCT
TAGAATCAGCT: AGAATCAGCTC
AGAATCAGCTC: GAATCAGCTCT
GAATCAGCTCT: AATCAGCTCTT
AATCAGCTCTT: ATCAGCTCTTA
ATCAGCTCTTA: TCAGCTCTTAA
TCAGCTCTTAA: CAGCTCTTAAT
CAGCTCTTAAT: AGCTCTTAATC
AGCTCTTAATC: GCTCTTAATCC
GCTCTTAATCC: CTCTTAATCCC
CTCTTAATCCC: TCTTAATCCCT
TCTTAATCCCT: CTTAATCCCTT
CTTAATCCCTT: TTAATCCCTTA
TTAATCCCTTA: TAATCCCTTAA
TAATCCCTTAA: AATCCCTTAAA
AATCCCTTAAA: ATCCCTTAAAC
ATCCCTTAAAC: TCCCTTAAACC
TCCCTTAAACC: CCCTTAAACCT
CCCTTAAACCT: CCTTAAACCTT
CCTTAAACCTT: CTTAAACCTTC
CTTAAACCTTC: TTAAACCTTCG
TTAAACCTTCG: TAAACCTTCGG
TAAACCTTCGG: AAACCTTCGGC
AAACCTTCGGC: AACCTTCGGCC
AACCTTCGGCC: ACCTTCGGCCG
ACCTTCGGCCG: CCTTCGGCCGA
CCTTCGGCCGA: CTTCGGCCGAA
CTTCGGCCGAA: TTCGGCCGAAC
TTCGGCCGAAC: TCGGCCGAACC
TCGGCCGAACC: CGGCCGAACCC
CGGCCGAACCC: GGCCGAACCCC
GGCCGAACCCC: GCCGAACCCCG
GCCGAACCCCG: CCGAACCCCGG
CCGAACCCCGG: CGAACCCCGGT
CGAACCCCGGT: GAACCCCGGTA
GAACCCCGGTA: AACCCCGGTAC
AACCCCGGTAC: ACCCCGGTACC
ACCCCGGTACC: CCCCGGTACCA
CCCCGGTACCA: CCCGGTACCAA
CCCGGTACCAA: CCGGTACCAAT
CCGGTACCAAT: CGGTACCAATG
CGGTACCAATG: GGTACCAATGG
GGTACCAATGG: GTACCAATGGT
GTACCAATGGT: TACCAATGGTT
TACCAATGGTT: ACCAATGGTTG
ACCAATGGTTG: CCAATGGTTGA
CCAATGGTTGA: CAATGGTTGAT
CAATGGTTGAT: AATGGTTGATA
AATGGTTGATA: ATGGTTGATAG
ATGGTTGATAG: TGGTTGATAGA
TGGTTGATAGA: GGTTGATAGAT
GGTTGATAGAT: GTTGATAGATA
GTTGATAGATA: TTGATAGATAG
TTGATAGATAG: TGATAGATAGG
TGATAGATAGG: GATAGATAGGT
GATAGATAGGT: ATAGATAGGTA
ATAGATAGGTA: TAGATAGGTAT
TAGATAGGTAT: AGATAGGTATA
AGATAGGTATA: GATAGGTATAG
GATAGGTATAG: ATAGGTATAGG
ATAGGTATAGG: TAGGTATAGGC
TAGGTATAGGC: AGGTATAGGCA
AGGTATAGGCA: GGTATAGGCAC
GGTATAGGCAC: GTATAGGCACC
GTATAGGCACC: TATAGGCACCA
TATAGGCACCA: ATAGGCACCAG
ATAGGCACCAG: TAGGCACCAGC
TAGGCACCAGC: AGGCACCAGCT
AGGCACCAGCT: GGCACCAGCTC
GGCACCAGCTC: GCACCAGCTCG
GCACCAGCTCG: CACCAGCTCGT
CACCAGCTCGT: ACCAGCTCGTT
ACCAGCTCGTT: CCAGCTCGTTG
CCAGCTCGTTG: CAGCTCGTTGT
CAGCTCGTTGT: AGCTCGTTGTA
AGCTCGTTGTA: GCTCGTTGTAC
GCTCGTTGTAC: CTCGTTGTACA
CTCGTTGTACA: TCGTTGTACAG
TCGTTGTACAG: CGTTGTACAGA
CGTTGTACAGA: GTTGTACAGAG
GTTGTACAGAG: TTGTACAGAGG
TTGTACAGAGG: TGTACAGAGGT
TGTACAGAGGT: GTACAGAGGTA
GTACAGAGGTA: TACAGAGGTAT
TACAGAGGTAT: ACAGAGGTATT
ACAGAGGTATT: CAGAGGTATTC
CAGAGGTATTC: AGAGGTATTCG
AGAGGTATTCG: GAGGTATTCGG
GAGGTATTCGG: AGGTATTCGGG
AGGTATTCGGG: GGTATTCGGGG
GGTATTCGGGG: GTATTCGGGGG
GTATTCGGGGG: TATTCGGGGGT
TATTCGGGGGT: ATTCGGGGGTC
ATTCGGGGGTC: TTCGGGGGTCA
TTCGGGGGTCA: TCGGGGGTCAC
TCGGGGGTCAC: CGGGGGTCACC
CGGGGGTCACC: GGGGGTCACCA
GGGGGTCACCA: GGGGTCACCAG
GGGGTCACCAG: GGGTCACCAGA
GGGTCACCAGA: GGTCACCAGAC
GGTCACCAGAC: GTCACCAGACG
GTCACCAGACG: TCACCAGACGA
TCACCAGACGA: CACCAGACGAC
CACCAGACGAC: ACCAGACGACC
ACCAGACGACC: CCAGACGACCT
CCAGACGACCT: CAGACGACCTC
CAGACGACCTC: AGACGACCTCC
AGACGACCTCC: GACGACCTCCT
GACGACCTCCT: ACGACCTCCTC
ACGACCTCCTC: CGACCTCCTCA
CGACCTCCTCA: GACCTCCTCAC
GACCTCCTCAC: ACCTCCTCACG
ACCTCCTCACG: CCTCCTCACGA
CCTCCTCACGA: CTCCTCACGAA
CTCCTCACGAA: TCCTCACGAAT
TCCTCACGAAT: CCTCACGAATA
CCTCACGAATA: CTCACGAATAT
CTCACGAATAT: TCACGAATATT
TCACGAATATT: CACGAATATTT
CACGAATATTT: ACGAATATTTG
ACGAATATTTG: CGAATATTTGG
CGAATATTTGG: GAATATTTGGC
GAATATTTGGC: AATATTTGGCG
AATATTTGGCG: ATATTTGGCGC
ATATTTGGCGC: TATTTGGCGCT
TATTTGGCGCT: ATTTGGCGCTT
ATTTGGCGCTT: TTTGGCGCTTT
TTTGGCGCTTT: TTGGCGCTTTC
TTGGCGCTTTC: TGGCGCTTTCC
TGGCGCTTTCC: GGCGCTTTCCC
GGCGCTTTCCC: GCGCTTTCCCA
GCGCTTTCCCA: CGCTTTCCCAT
CGCTTTCCCAT: GCTTTCCCATC
GCTTTCCCATC: CTTTCCCATCG
CTTTCCCATCG: TTTCCCATCGG
TTTCCCATCGG: TTCCCATCGGG
TTCCCATCGGG: TCCCATCGGGC
TCCCATCGGGC: CCCATCGGGCT
CCCATCGGGCT: CCATCGGGCTT
CCATCGGGCTT: CATCGGGCTTC
CATCGGGCTTC: ATCGGGCTTCG
ATCGGGCTTCG: TCGGGCTTCGC
TCGGGCTTCGC: CGGGCTTCGCA
CGGGCTTCGCA: GGGCTTCGCAG
GGGCTTCGCAG: GGCTTCGCAGA
GGCTTCGCAGA: GCTTCGCAGAG
GCTTCGCAGAG: CTTCGCAGAGA
CTTCGCAGAGA: TTCGCAGAGAA
TTCGCAGAGAA: TCGCAGAGAAG
TCGCAGAGAAG: CGCAGAGAAGT
CGCAGAGAAGT: GCAGAGAAGTA
GCAGAGAAGTA: CAGAGAAGTAG
CAGAGAAGTAG: AGAGAAGTAGA
AGAGAAGTAGA: GAGAAGTAGAA
GAGAAGTAGAA: AGAAGTAGAAG
AGAAGTAGAAG: GAAGTAGAAGA
GAAGTAGAAGA: AAGTAGAAGAG
AAGTAGAAGAG: AGTAGAAGAGG
AGTAGAAGAGG: GTAGAAGAGGC
GTAGAAGAGGC: TAGAAGAGGCC
TAGAAGAGGCC: AGAAGAGGCCT
AGAAGAGGCCT: GAAGAGGCCTA
GAAGAGGCCTA: AAGAGGCCTAC
AAGAGGCCTAC: AGAGGCCTACG
AGAGGCCTACG: GAGGCCTACGG
GAGGCCTACGG: AGGCCTACGGG
AGGCCTACGGG: GGCCTACGGGT
GGCCTACGGGT: GCCTACGGGTG
GCCTACGGGTG: CCTACGGGTGT
CCTACGGGTGT: CTACGGGTGTC
CTACGGGTGTC: TACGGGTGTCT
TACGGGTGTCT: ACGGGTGTCTC
ACGGGTGTCTC: CGGGTGTCTCC
CGGGTGTCTCC: GGGTGTCTCCT
GGGTGTCTCCT: GGTGTCTCCTG
GGTGTCTCCTG: GTGTCTCCTGC
GTGTCTCCTGC: TGTCTCCTGCC
TGTCTCCTGCC: GTCTCCTGCCG
GTCTCCTGCCG: TCTCCTGCCGC
TCTCCTGCCGC: CTCCTGCCGCG
CTCCTGCCGCG: TCCTGCCGCGA
TCCTGCCGCGA: CCTGCCGCGAG
CCTGCCGCGAG: CTGCCGCGAGC
CTGCCGCGAGC: TGCCGCGAGCA
TGCCGCGAGCA: GCCGCGAGCAG
GCCGCGAGCAG: CCGCGAGCAGT
CCGCGAGCAGT: CGCGAGCAGTG
CGCGAGCAGTG: GCGAGCAGTGT
GCGAGCAGTGT: CGAGCAGTGTT
CGAGCAGTGTT: GAGCAGTGTTC
GAGCAGTGTTC: AGCAGTGTTCT
AGCAGTGTTCT: GCAGTGTTCTC
GCAGTGTTCTC: CAGTGTTCTCT
CAGTGTTCTCT: AGTGTTCTCTA
AGTGTTCTCTA: GTGTTCTCTAA
GTGTTCTCTAA: TGTTCTCTAAT
TGTTCTCTAAT: GTTCTCTAATC
GTTCTCTAATC: TTCTCTAATCT
TTCTCTAATCT: TCTCTAATCTA
TCTCTAATCTA: CTCTAATCTAC
CTCTAATCTAC: TCTAATCTACC
TCTAATCTACC: CTAATCTACCC
CTAATCTACCC: TAATCTACCCG
TAATCTACCCG: AATCTACCCGG
AATCTACCCGG: ATCTACCCGGA
ATCTACCCGGA: TCTACCCGGAT
TCTACCCGGAT: CTACCCGGATT
CTACCCGGATT: TACCCGGATTG
TACCCGGATTG: ACCCGGATTGC
ACCCGGATTGC: CCCGGATTGCC
CCCGGATTGCC: CCGGATTGCCG
CCGGATTGCCG: CGGATTGCCGC
CGGATTGCCGC: GGATTGCCGCA
GGATTGCCGCA: GATTGCCGCAC
GATTGCCGCAC: ATTGCCGCACA
ATTGCCGCACA: TTGCCGCACAC
TTGCCGCACAC: TGCCGCACACC
TGCCGCACACC: GCCGCACACCC
GCCGCACACCC: CCGCACACCCC
CCGCACACCCC: CGCACACCCCG
CGCACACCCCG: GCACACCCCGC
GCACACCCCGC: CACACCCCGCG
CACACCCCGCG: ACACCCCGCGG
ACACCCCGCGG: CACCCCGCGGT
CACCCCGCGGT: ACCCCGCGGTT
ACCCCGCGGTT: CCCCGCGGTTT
CCCCGCGGTTT: CCCGCGGTTTG
CCCGCGGTTTG: CCGCGGTTTGT
CCGCGGTTTGT: CGCGGTTTGTA
CGCGGTTTGTA: GCGGTTTGTAG
GCGGTTTGTAG: CGGTTTGTAGT
CGGTTTGTAGT: GGTTTGTAGTC
GGTTTGTAGTC: GTTTGTAGTCT
GTTTGTAGTCT: TTTGTAGTCTC
TTTGTAGTCTC: TTGTAGTCTCT
TTGTAGTCTCT: TGTAGTCTCTG
TGTAGTCTCTG: GTAGTCTCTGA
GTAGTCTCTGA: TAGTCTCTGAC
TAGTCTCTGAC: AGTCTCTGACA
AGTCTCTGACA: GTCTCTGACAT
GTCTCTGACAT: TCTCTGACATC
TCTCTGACATC: CTCTGACATCC
CTCTGACATCC: TCTGACATCCC
TCTGACATCCC: CTGACATCCCC
CTGACATCCCC: TGACATCCCCC
TGACATCCCCC: GACATCCCCCT
GACATCCCCCT: ACATCCCCCTA
ACATCCCCCTA: CATCCCCCTAT
CATCCCCCTAT: ATCCCCCTATT
ATCCCCCTATT: TCCCCCTATTT
TCCCCCTATTT: CCCCCTATTTC
CCCCCTATTTC: CCCCTATTTCG
CCCCTATTTCG: CCCTATTTCGT
CCCTATTTCGT: CCTATTTCGTG
CCTATTTCGTG: CTATTTCGTGC
CTATTTCGTGC: TATTTCGTGCC
TATTTCGTGCC: ATTTCGTGCCT
ATTTCGTGCCT: TTTCGTGCCTG
TTTCGTGCCTG: TTCGTGCCTGA
TTCGTGCCTGA: TCGTGCCTGAC
TCGTGCCTGAC: CGTGCCTGACT
CGTGCCTGACT: GTGCCTGACTA
GTGCCTGACTA: TGCCTGACTAA
TGCCTGACTAA: GCCTGACTAAC
GCCTGACTAAC: CCTGACTAACA
CCTGACTAACA: CTGACTAACAC
CTGACTAACAC: TGACTAACACC
TGACTAACACC: GACTAACACCG
GACTAACACCG: ACTAACACCGG
ACTAACACCGG: CTAACACCGGC
CTAACACCGGC: TAACACCGGCT
TAACACCGGCT: AACACCGGCTC
AACACCGGCTC: ACACCGGCTCT
ACACCGGCTCT: CACCGGCTCTC
CACCGGCTCTC: ACCGGCTCTCA
ACCGGCTCTCA: CCGGCTCTCAA
CCGGCTCTCAA: CGGCTCTCAAT
CGGCTCTCAAT: GGCTCTCAATG
GGCTCTCAATG: GCTCTCAATGA
GCTCTCAATGA: CTCTCAATGAT
CTCTCAATGAT: TCTCAATGATA
TCTCAATGATA: CTCAATGATAG
CTCAATGATAG: TCAATGATAGA
TCAATGATAGA: CAATGATAGAA
CAATGATAGAA: AATGATAGAAC
AATGATAGAAC: ATGATAGAACA
ATGATAGAACA: TGATAGAACAG
TGATAGAACAG: GATAGAACAGC
GATAGAACAGC: ATAGAACAGCC
ATAGAACAGCC: TAGAACAGCCC
TAGAACAGCCC: AGAACAGCCCA
AGAACAGCCCA: GAACAGCCCAT
GAACAGCCCAT: AACAGCCCATA
AACAGCCCATA: ACAGCCCATAG
ACAGCCCATAG: CAGCCCATAGA
CAGCCCATAGA: AGCCCATAGAA
AGCCCATAGAA: GCCCATAGAAA
GCCCATAGAAA: CCCATAGAAAC
CCCATAGAAAC: CCATAGAAACA
CCATAGAAACA: CATAGAAACAG
CATAGAAACAG: ATAGAAACAGT
ATAGAAACAGT: TAGAAACAGTT
TAGAAACAGTT: AGAAACAGTTG
AGAAACAGTTG: GAAACAGTTGG
GAAACAGTTGG: AAACAGTTGGT
AAACAGTTGGT: AACAGTTGGTC
AACAGTTGGTC: ACAGTTGGTCG
ACAGTTGGTCG: CAGTTGGTCGG
CAGTTGGTCGG: AGTTGGTCGGC
AGTTGGTCGGC: GTTGGTCGGCC
GTTGGTCGGCC: TTGGTCGGCCA
TTGGTCGGCCA: TGGTCGGCCAA
TGGTCGGCCAA: GGTCGGCCAAA
GGTCGGCCAAA: GTCGGCCAAAC
GTCGGCCAAAC: TCGGCCAAACA
TCGGCCAAACA: CGGCCAAACAT
CGGCCAAACAT: GGCCAAACATC
GGCCAAACATC: GCCAAACATCG
GCCAAACATCG: CCAAACATCGA
CCAAACATCGA: CAAACATCGAT
CAAACATCGAT: AAACATCGATA
AAACATCGATA: AACATCGATAG
AACATCGATAG: ACATCGATAGG
ACATCGATAGG: CATCGATAGGC
CATCGATAGGC: ATCGATAGGCC
ATCGATAGGCC: TCGATAGGCCG
TCGATAGGCCG: CGATAGGCCGC
CGATAGGCCGC: GATAGGCCGCA
GATAGGCCGCA: ATAGGCCGCAG
ATAGGCCGCAG: TAGGCCGCAGC
TAGGCCGCAGC: AGGCCGCAGCT
AGGCCGCAGCT: GGCCGCAGCTC
GGCCGCAGCTC: GCCGCAGCTCG
GCCGCAGCTCG: CCGCAGCTCGC
CCGCAGCTCGC: CGCAGCTCGCC
CGCAGCTCGCC: GCAGCTCGCCC
GCAGCTCGCCC: CAGCTCGCCCC
CAGCTCGCCCC: AGCTCGCCCCT
AGCTCGCCCCT: GCTCGCCCCTA
GCTCGCCCCTA: CTCGCCCCTAA
CTCGCCCCTAA: TCGCCCCTAAC
TCGCCCCTAAC: CGCCCCTAACG
CGCCCCTAACG: GCCCCTAACGG
GCCCCTAACGG: CCCCTAACGGT
CCCCTAACGGT: CCCTAACGGTT
CCCTAACGGTT: CCTAACGGTTG
CCTAACGGTTG: CTAACGGTTGA
CTAACGGTTGA: TAACGGTTGAA
TAACGGTTGAA: AACGGTTGAAG
AACGGTTGAAG: ACGGTTGAAGG
ACGGTTGAAGG: CGGTTGAAGGA
CGGTTGAAGGA: GGTTGAAGGAC
GGTTGAAGGAC: GTTGAAGGACA
GTTGAAGGACA: TTGAAGGACAG
TTGAAGGACAG: TGAAGGACAGC
TGAAGGACAGC: GAAGGACAGCG
GAAGGACAGCG: AAGGACAGCGG
AAGGACAGCGG: AGGACAGCGGT
AGGACAGCGGT: GGACAGCGGTT
GGACAGCGGTT: GACAGCGGTTC
GACAGCGGTTC: ACAGCGGTTCG
ACAGCGGTTCG: CAGCGGTTCGG
CAGCGGTTCGG: AGCGGTTCGGC
AGCGGTTCGGC: GCGGTTCGGCG
GCGGTTCGGCG: CGGTTCGGCGG
CGGTTCGGCGG: GGTTCGGCGGG
GGTTCGGCGGG: GTTCGGCGGGG
GTTCGGCGGGG: TTCGGCGGGGC
TTCGGCGGGGC: TCGGCGGGGCC
TCGGCGGGGCC: CGGCGGGGCCG
CGGCGGGGCCG: GGCGGGGCCGA
GGCGGGGCCGA: GCGGGGCCGAA
GCGGGGCCGAA: CGGGGCCGAAC
CGGGGCCGAAC: GGGGCCGAACG
GGGGCCGAACG: GGGCCGAACGT
GGGCCGAACGT: GGCCGAACGTA
GGCCGAACGTA: GCCGAACGTAG
GCCGAACGTAG: CCGAACGTAGC
CCGAACGTAGC: CGAACGTAGCG
CGAACGTAGCG: GAACGTAGCGT
GAACGTAGCGT: AACGTAGCGTC
AACGTAGCGTC: ACGTAGCGTCT
ACGTAGCGTCT: CGTAGCGTCTT
CGTAGCGTCTT: GTAGCGTCTTC
GTAGCGTCTTC: TAGCGTCTTCA
TAGCGTCTTCA: AGCGTCTTCAC
AGCGTCTTCAC: GCGTCTTCACG
GCGTCTTCACG: CGTCTTCACGA
CGTCTTCACGA: GTCTTCACGAT
GTCTTCACGAT: TCTTCACGATG
TCTTCACGATG: CTTCACGATGT
CTTCACGATGT: TTCACGATGTA
TTCACGATGTA: TCACGATGTAT
TCACGATGTAT: CACGATGTATA
CACGATGTATA: ACGATGTATAT
ACGATGTATAT: CGATGTATATC
CGATGTATATC: GATGTATATCC
GATGTATATCC: ATGTATATCCC
ATGTATATCCC: TGTATATCCCT
TGTATATCCCT: GTATATCCCTC
GTATATCCCTC: TATATCCCTCT
TATATCCCTCT: ATATCCCTCTG
ATATCCCTCTG: TATCCCTCTGA
TATCCCTCTGA: ATCCCTCTGAG
ATCCCTCTGAG: TCCCTCTGAGG
TCCCTCTGAGG: CCCTCTGAGGA
CCCTCTGAGGA: CCTCTGAGGAT
CCTCTGAGGAT: CTCTGAGGATA
CTCTGAGGATA: TCTGAGGATAA
TCTGAGGATAA: CTGAGGATAAA
CTGAGGATAAA: TGAGGATAAAT
TGAGGATAAAT: GAGGATAAATG
GAGGATAAATG: AGGATAAATGT
AGGATAAATGT: GGATAAATGTC
GGATAAATGTC: GATAAATGTCA
GATAAATGTCA: ATAAATGTCAC
ATAAATGTCAC: TAAATGTCACT
TAAATGTCACT: AAATGTCACTA
AAATGTCACTA: AATGTCACTAG
AATGTCACTAG: ATGTCACTAGT
ATGTCACTAGT: TGTCACTAGTC
TGTCACTAGTC: GTCACTAGTCG
GTCACTAGTCG: TCACTAGTCGG
TCACTAGTCGG: CACTAGTCGGC
CACTAGTCGGC: ACTAGTCGGCG
ACTAGTCGGCG: CTAGTCGGCGC
CTAGTCGGCGC: TAGTCGGCGCC
TAGTCGGCGCC: AGTCGGCGCCA
AGTCGGCGCCA: GTCGGCGCCAT
GTCGGCGCCAT: TCGGCGCCATA
TCGGCGCCATA: CGGCGCCATAT
CGGCGCCATAT: GGCGCCATATT
GGCGCCATATT: GCGCCATATTC
GCGCCATATTC: CGCCATATTCG
CGCCATATTCG: GCCATATTCGG
GCCATATTCGG: CCATATTCGGC
CCATATTCGGC: CATATTCGGCC
CATATTCGGCC: ATATTCGGCCT
ATATTCGGCCT: TATTCGGCCTA
TATTCGGCCTA: ATTCGGCCTAA
ATTCGGCCTAA: TTCGGCCTAAC
TTCGGCCTAAC: TCGGCCTAACA
TCGGCCTAACA: CGGCCTAACAG
CGGCCTAACAG: GGCCTAACAGT
GGCCTAACAGT: GCCTAACAGTA
GCCTAACAGTA: CCTAACAGTAC
CCTAACAGTAC: CTAACAGTACA
CTAACAGTACA: TAACAGTACAA
TAACAGTACAA: AACAGTACAAT
AACAGTACAAT: ACAGTACAATT
ACAGTACAATT: CAGTACAATTC
CAGTACAATTC: AGTACAATTCA
AGTACAATTCA: GTACAATTCAG
GTACAATTCAG: TACAATTCAGT
TACAATTCAGT: ACAATTCAGTT
ACAATTCAGTT: CAATTCAGTTT
CAATTCAGTTT: AATTCAGTTTC
AATTCAGTTTC: ATTCAGTTTCC
ATTCAGTTTCC: TTCAGTTTCCG
TTCAGTTTCCG: TCAGTTTCCGG
TCAGTTTCCGG: CAGTTTCCGGT
CAGTTTCCGGT: AGTTTCCGGTC
AGTTTCCGGTC: GTTTCCGGTCA
GTTTCCGGTCA: TTTCCGGTCAT
TTTCCGGTCAT: TTCCGGTCATG
TTCCGGTCATG: TCCGGTCATGC
TCCGGTCATGC: CCGGTCATGCG
CCGGTCATGCG: CGGTCATGCGG
CGGTCATGCGG: GGTCATGCGGA
GGTCATGCGGA: GTCATGCGGAT
GTCATGCGGAT: TCATGCGGATT
TCATGCGGATT: CATGCGGATTC
CATGCGGATTC: ATGCGGATTCA
ATGCGGATTCA: TGCGGATTCAA
TGCGGATTCAA: GCGGATTCAAA
GCGGATTCAAA: CGGATTCAAAC
CGGATTCAAAC: GGATTCAAACA
GGATTCAAACA: GATTCAAACAG
GATTCAAACAG: ATTCAAACAGG
ATTCAAACAGG: TTCAAACAGGT
TTCAAACAGGT: TCAAACAGGTA
TCAAACAGGTA: CAAACAGGTAT
CAAACAGGTAT: AAACAGGTATG
AAACAGGTATG: AACAGGTATGG
AACAGGTATGG: ACAGGTATGGC
ACAGGTATGGC: CAGGTATGGCC
CAGGTATGGCC: AGGTATGGCCG
AGGTATGGCCG: GGTATGGCCGT
GGTATGGCCGT: GTATGGCCGTA
GTATGGCCGTA: TATGGCCGTAC
TATGGCCGTAC: ATGGCCGTACA
ATGGCCGTACA: TGGCCGTACAC
TGGCCGTACAC: GGCCGTACACC
GGCCGTACACC: GCCGTACACCG
GCCGTACACCG: CCGTACACCGG
CCGTACACCGG: CGTACACCGGA
CGTACACCGGA: GTACACCGGAC
GTACACCGGAC: TACACCGGACT
TACACCGGACT: ACACCGGACTC
ACACCGGACTC: CACCGGACTCG
CACCGGACTCG: ACCGGACTCGT
ACCGGACTCGT: CCGGACTCGTG
CCGGACTCGTG: CGGACTCGTGC
CGGACTCGTGC: GGACTCGTGCG
GGACTCGTGCG: GACTCGTGCGA
GACTCGTGCGA: ACTCGTGCGAC
ACTCGTGCGAC: CTCGTGCGACT
CTCGTGCGACT: TCGTGCGACTG
TCGTGCGACTG: CGTGCGACTGT
CGTGCGACTGT: GTGCGACTGTA
GTGCGACTGTA: TGCGACTGTAT
TGCGACTGTAT: GCGACTGTATA
GCGACTGTATA: CGACTGTATAC
CGACTGTATAC: GACTGTATACA
GACTGTATACA: ACTGTATACAG
ACTGTATACAG: CTGTATACAGC
CTGTATACAGC: TGTATACAGCG
TGTATACAGCG: GTATACAGCGT
GTATACAGCGT: TATACAGCGTC
TATACAGCGTC: ATACAGCGTCG
ATACAGCGTCG: TACAGCGTCGT
TACAGCGTCGT: ACAGCGTCGTG
ACAGCGTCGTG: CAGCGTCGTGC
CAGCGTCGTGC: AGCGTCGTGCT
AGCGTCGTGCT: GCGTCGTGCTA
GCGTCGTGCTA: CGTCGTGCTAC
CGTCGTGCTAC: GTCGTGCTACC
GTCGTGCTACC: TCGTGCTACCG
TCGTGCTACCG: CGTGCTACCGG
CGTGCTACCGG: GTGCTACCGGA
GTGCTACCGGA: TGCTACCGGAT
TGCTACCGGAT: GCTACCGGATA
GCTACCGGATA: CTACCGGATAA
CTACCGGATAA: TACCGGATAAC
TACCGGATAAC: ACCGGATAACA
ACCGGATAACA: CCGGATAACAG
CCGGATAACAG: CGGATAACAGA
CGGATAACAGA: GGATAACAGAG
GGATAACAGAG: GATAACAGAGC
GATAACAGAGC: ATAACAGAGCG
ATAACAGAGCG: TAACAGAGCGA
TAACAGAGCGA: AACAGAGCGAC
AACAGAGCGAC: ACAGAGCGACA
ACAGAGCGACA: CAGAGCGACAA
CAGAGCGACAA: AGAGCGACAAG
AGAGCGACAAG: GAGCGACAAGG
GAGCGACAAGG: AGCGACAAGGC
AGCGACAAGGC: GCGACAAGGCG
GCGACAAGGCG: CGACAAGGCGA
CGACAAGGCGA: GACAAGGCGAA
GACAAGGCGAA: ACAAGGCGAAA
ACAAGGCGAAA: CAAGGCGAAAG
CAAGGCGAAAG: AAGGCGAAAGG
AAGGCGAAAGG: AGGCGAAAGGC
AGGCGAAAGGC: GGCGAAAGGCC
GGCGAAAGGCC: GCGAAAGGCCG
GCGAAAGGCCG: CGAAAGGCCGC
CGAAAGGCCGC: GAAAGGCCGCC
GAAAGGCCGCC: AAAGGCCGCCC
AAAGGCCGCCC: AAGGCCGCCCG
AAGGCCGCCCG: AGGCCGCCCGG
AGGCCGCCCGG: GGCCGCCCGGG
GGCCGCCCGGG: GCCGCCCGGGC
GCCGCCCGGGC: CCGCCCGGGCC
CCGCCCGGGCC: CGCCCGGGCCA
CGCCCGGGCCA: GCCCGGGCCAG
GCCCGGGCCAG: CCCGGGCCAGA
CCCGGGCCAGA: CCGGGCCAGAT
CCGGGCCAGAT: CGGGCCAGATA
CGGGCCAGATA: GGGCCAGATAA
GGGCCAGATAA: GGCCAGATAAA
GGCCAGATAAA: GCCAGATAAAT
GCCAGATAAAT: CCAGATAAATC
CCAGATAAATC: CAGATAAATCC
CAGATAAATCC: AGATAAATCCA
AGATAAATCCA: GATAAATCCAT
GATAAATCCAT: ATAAATCCATT
ATAAATCCATT: TAAATCCATTA
TAAATCCATTA: AAATCCATTAT
AAATCCATTAT: AATCCATTATG
AATCCATTATG: ATCCATTATGA
ATCCATTATGA: TCCATTATGAG
TCCATTATGAG: CCATTATGAGG
CCATTATGAGG: CATTATGAGGG
CATTATGAGGG: ATTATGAGGGT
ATTATGAGGGT: TTATGAGGGTG
TTATGAGGGTG: TATGAGGGTGC
TATGAGGGTGC: ATGAGGGTGCA
ATGAGGGTGCA: TGAGGGTGCAT
TGAGGGTGCAT: GAGGGTGCATA
GAGGGTGCATA: AGGGTGCATAG
AGGGTGCATAG: GGGTGCATAGG
GGGTGCATAGG: GGTGCATAGGG
GGTGCATAGGG: GTGCATAGGGA
GTGCATAGGGA: TGCATAGGGAT
TGCATAGGGAT: GCATAGGGATT
GCATAGGGATT: CATAGGGATTC
CATAGGGATTC: ATAGGGATTCG
ATAGGGATTCG: TAGGGATTCGC
TAGGGATTCGC: AGGGATTCGCT
AGGGATTCGCT: GGGATTCGCTT
GGGATTCGCTT: GGATTCGCTTA
GGATTCGCTTA: GATTCGCTTAA
GATTCGCTTAA: ATTCGCTTAAA
ATTCGCTTAAA: TTCGCTTAAAG
TTCGCTTAAAG: TCGCTTAAAGG
TCGCTTAAAGG: CGCTTAAAGGG
CGCTTAAAGGG: GCTTAAAGGGC
GCTTAAAGGGC: CTTAAAGGGCA
CTTAAAGGGCA: TTAAAGGGCAA
TTAAAGGGCAA: TAAAGGGCAAG
TAAAGGGCAAG: AAAGGGCAAGT
AAAGGGCAAGT: AAGGGCAAGTA
AAGGGCAAGTA: AGGGCAAGTAG
AGGGCAAGTAG: GGGCAAGTAGC
GGGCAAGTAGC: GGCAAGTAGCC
GGCAAGTAGCC: GCAAGTAGCCG
GCAAGTAGCCG: CAAGTAGCCGA
CAAGTAGCCGA: AAGTAGCCGAG
AAGTAGCCGAG: AGTAGCCGAGG
AGTAGCCGAGG: GTAGCCGAGGC
GTAGCCGAGGC: TAGCCGAGGCG
TAGCCGAGGCG: AGCCGAGGCGT
AGCCGAGGCGT: GCCGAGGCGTG
GCCGAGGCGTG: CCGAGGCGTGT
CCGAGGCGTGT: CGAGGCGTGTC
CGAGGCGTGTC: GAGGCGTGTCC
GAGGCGTGTCC: AGGCGTGTCCA
AGGCGTGTCCA: GGCGTGTCCAA
GGCGTGTCCAA: GCGTGTCCAAA
GCGTGTCCAAA: CGTGTCCAAAT
CGTGTCCAAAT: GTGTCCAAATG
GTGTCCAAATG: TGTCCAAATGG
TGTCCAAATGG: GTCCAAATGGG
GTCCAAATGGG: TCCAAATGGGA
TCCAAATGGGA: CCAAATGGGAA
CCAAATGGGAA: CAAATGGGAAG
CAAATGGGAAG: AAATGGGAAGG
AAATGGGAAGG: AATGGGAAGGC
AATGGGAAGGC: ATGGGAAGGCG
ATGGGAAGGCG: TGGGAAGGCGA
TGGGAAGGCGA: GGGAAGGCGAA
GGGAAGGCGAA: GGAAGGCGAAG
GGAAGGCGAAG: GAAGGCGAAGA
GAAGGCGAAGA: AAGGCGAAGAA
AAGGCGAAGAA: AGGCGAAGAAG
AGGCGAAGAAG: GGCGAAGAAGC
GCGAAGAAGCC: CGAAGAAGCCG
CGAAGAAGCCG: GAAGAAGCCGA
GAAGAAGCCGA: AAGAAGCCGAT
AAGAAGCCGAT: AGAAGCCGATG
AGAAGCCGATG: GAAGCCGATGT
GAAGCCGATGT: AAGCCGATGTG
AAGCCGATGTG: AGCCGATGTGA
AGCCGATGTGA: GCCGATGTGAA
GCCGATGTGAA: CCGATGTGAAA
CCGATGTGAAA: CGATGTGAAAT
CGATGTGAAAT: GATGTGAAATT
GATGTGAAATT: ATGTGAAATTG
ATGTGAAATTG: TGTGAAATTGG
TGTGAAATTGG: GTGAAATTGGT
GTGAAATTGGT: TGAAATTGGTA
TGAAATTGGTA: GAAATTGGTAA
GAAATTGGTAA: AAATTGGTAAA
AAATTGGTAAA: AATTGGTAAAT
AATTGGTAAAT: ATTGGTAAATT
ATTGGTAAATT: TTGGTAAATTC
TTGGTAAATTC: TGGTAAATTCG
TGGTAAATTCG: GGTAAATTCGA
GGTAAATTCGA: GTAAATTCGAG
GTAAATTCGAG: TAAATTCGAGC
TAAATTCGAGC: AAATTCGAGCG
AAATTCGAGCG: AATTCGAGCGC
AATTCGAGCGC: ATTCGAGCGCC
ATTCGAGCGCC: TTCGAGCGCCT
TTCGAGCGCCT: TCGAGCGCCTC
TCGAGCGCCTC: CGAGCGCCTCT
CGAGCGCCTCT: GAGCGCCTCTC
GAGCGCCTCTC: AGCGCCTCTCG
AGCGCCTCTCG: GCGCCTCTCGA
GCGCCTCTCGA: CGCCTCTCGAA
CGCCTCTCGAA: GCCTCTCGAAA
GCCTCTCGAAA: CCTCTCGAAAC
CCTCTCGAAAC: CTCTCGAAACA
CTCTCGAAACA: TCTCGAAACAA
TCTCGAAACAA: CTCGAAACAAA
CTCGAAACAAA: TCGAAACAAAC
TCGAAACAAAC: CGAAACAAACA
CGAAACAAACA: GAAACAAACAA
GAAACAAACAA: AAACAAACAAA
AAACAAACAAA: AACAAACAAAG
AACAAACAAAG: ACAAACAAAGT
ACAAACAAAGT: CAAACAAAGTA
CAAACAAAGTA: AAACAAAGTAC
AAACAAAGTAC: AACAAAGTACG
AACAAAGTACG: ACAAAGTACGT
ACAAAGTACGT: CAAAGTACGTA
CAAAGTACGTA: AAAGTACGTAA
AAAGTACGTAA: AAGTACGTAAG
AAGTACGTAAG: AGTACGTAAGG
AGTACGTAAGG: GTACGTAAGGA
GTACGTAAGGA: TACGTAAGGAA
TACGTAAGGAA: ACGTAAGGAAG
ACGTAAGGAAG: CGTAAGGAAGG
CGTAAGGAAGG: GTAAGGAAGGT
GTAAGGAAGGT: TAAGGAAGGTG
TAAGGAAGGTG: AAGGAAGGTGA
AAGGAAGGTGA: AGGAAGGTGAG
AGGAAGGTGAG: GGAAGGTGAGA
GGAAGGTGAGA: GAAGGTGAGAA
GAAGGTGAGAA: AAGGTGAGAAC
AAGGTGAGAAC: AGGTGAGAACT
AGGTGAGAACT: GGTGAGAACTA
GGTGAGAACTA: GTGAGAACTAT
GTGAGAACTAT: TGAGAACTATC
TGAGAACTATC: GAGAACTATCG
GAGAACTATCG: AGAACTATCGG
AGAACTATCGG: GAACTATCGGC
GAACTATCGGC: AACTATCGGCC
AACTATCGGCC: ACTATCGGCCC
ACTATCGGCCC: CTATCGGCCCT
CTATCGGCCCT: TATCGGCCCTT
TATCGGCCCTT: ATCGGCCCTTA
ATCGGCCCTTA: TCGGCCCTTAA
TCGGCCCTTAA: CGGCCCTTAAT
CGGCCCTTAAT: GGCCCTTAATA
GGCCCTTAATA: GCCCTTAATAT
GCCCTTAATAT: CCCTTAATATC
CCCTTAATATC: CCTTAATATCT
CCTTAATATCT: CTTAATATCTT
CTTAATATCTT: TTAATATCTTC
TTAATATCTTC: TAATATCTTCC
TAATATCTTCC: AATATCTTCCA
AATATCTTCCA: ATATCTTCCAT
ATATCTTCCAT: TATCTTCCATG
TATCTTCCATG: ATCTTCCATGG
ATCTTCCATGG: TCTTCCATGGG
TCTTCCATGGG: CTTCCATGGGG
CTTCCATGGGG: TTCCATGGGGG
TTCCATGGGGG: TCCATGGGGGT
TCCATGGGGGT: CCATGGGGGTC
CCATGGGGGTC: CATGGGGGTCA
CATGGGGGTCA: ATGGGGGTCAT
ATGGGGGTCAT: TGGGGGTCATC
TGGGGGTCATC: GGGGGTCATCA
GGGGGTCATCA: GGGGTCATCAT
GGGGTCATCAT: GGGTCATCATT
GGGTCATCATT: GGTCATCATTA
GGTCATCATTA: GTCATCATTAG
GTCATCATTAG: TCATCATTAGC
TCATCATTAGC: CATCATTAGCG
CATCATTAGCG: ATCATTAGCGA
ATCATTAGCGA: TCATTAGCGAC
TCATTAGCGAC: CATTAGCGACC
CATTAGCGACC: ATTAGCGACCA
ATTAGCGACCA: TTAGCGACCAA
TTAGCGACCAA: TAGCGACCAAG
TAGCGACCAAG: AGCGACCAAGT
AGCGACCAAGT: GCGACCAAGTG
GCGACCAAGTG: CGACCAAGTGG
CGACCAAGTGG: GACCAAGTGGC
GACCAAGTGGC: ACCAAGTGGCT
ACCAAGTGGCT: CCAAGTGGCTC
CCAAGTGGCTC: CAAGTGGCTCT
CAAGTGGCTCT: AAGTGGCTCTC
AAGTGGCTCTC: AGTGGCTCTCT
AGTGGCTCTCT: GTGGCTCTCTG
GTGGCTCTCTG: TGGCTCTCTGG
TGGCTCTCTGG: GGCTCTCTGGA
GGCTCTCTGGA: GCTCTCTGGAC
GCTCTCTGGAC: CTCTCTGGACA
CTCTCTGGACA: TCTCTGGACAG
TCTCTGGACAG: CTCTGGACAGT
CTCTGGACAGT: TCTGGACAGTG
TCTGGACAGTG: CTGGACAGTGC
CTGGACAGTGC: TGGACAGTGCG
TGGACAGTGCG: GGACAGTGCGT
GGACAGTGCGT: GACAGTGCGTT
GACAGTGCGTT: ACAGTGCGTTA
ACAGTGCGTTA: CAGTGCGTTAA
CAGTGCGTTAA: AGTGCGTTAAT
AGTGCGTTAAT: GTGCGTTAATA
GTGCGTTAATA: TGCGTTAATAC
TGCGTTAATAC: GCGTTAATACA
GCGTTAATACA: CGTTAATACAT
CGTTAATACAT: GTTAATACATT
GTTAATACATT: TTAATACATTC
TTAATACATTC: TAATACATTCA
TAATACATTCA: AATACATTCAG
AATACATTCAG: ATACATTCAGT
ATACATTCAGT: TACATTCAGTA
TACATTCAGTA: ACATTCAGTAA
ACATTCAGTAA: CATTCAGTAAT
CATTCAGTAAT: ATTCAGTAATG
ATTCAGTAATG: TTCAGTAATGC
TTCAGTAATGC: TCAGTAATGCT
TCAGTAATGCT: CAGTAATGCTG
CAGTAATGCTG: AGTAATGCTGG
AGTAATGCTGG: GTAATGCTGGC
GTAATGCTGGC: TAATGCTGGCA
TAATGCTGGCA: AATGCTGGCAC
AATGCTGGCAC: ATGCTGGCACA
ATGCTGGCACA: TGCTGGCACAC
TGCTGGCACAC: GCTGGCACACT
GCTGGCACACT: CTGGCACACTT
CTGGCACACTT: TGGCACACTTC
TGGCACACTTC: GGCACACTTCT
GGCACACTTCT: GCACACTTCTG
GCACACTTCTG: CACACTTCTGT
CACACTTCTGT: ACACTTCTGTC
ACACTTCTGTC: CACTTCTGTCA
CACTTCTGTCA: ACTTCTGTCAG
ACTTCTGTCAG: CTTCTGTCAGC
CTTCTGTCAGC: TTCTGTCAGCT
TTCTGTCAGCT: TCTGTCAGCTA
TCTGTCAGCTA: CTGTCAGCTAT
CTGTCAGCTAT: TGTCAGCTATT
TGTCAGCTATT: GTCAGCTATTT
GTCAGCTATTT: TCAGCTATTTA
TCAGCTATTTA: CAGCTATTTAA
CAGCTATTTAA: AGCTATTTAAT
AGCTATTTAAT: GCTATTTAATC
GCTATTTAATC: CTATTTAATCT
CTATTTAATCT: TATTTAATCTG
TATTTAATCTG: ATTTAATCTGG
ATTTAATCTGG: TTTAATCTGGC
TTTAATCTGGC: TTAATCTGGCT
TTAATCTGGCT: TAATCTGGCTT
TAATCTGGCTT: AATCTGGCTTA
AATCTGGCTTA: ATCTGGCTTAA
ATCTGGCTTAA: TCTGGCTTAAG
TCTGGCTTAAG: CTGGCTTAAGG
CTGGCTTAAGG: TGGCTTAAGGC
TGGCTTAAGGC: GGCTTAAGGCC
GGCTTAAGGCC: GCTTAAGGCCC
GCTTAAGGCCC: CTTAAGGCCCT
CTTAAGGCCCT: TTAAGGCCCTC
TTAAGGCCCTC: TAAGGCCCTCG
TAAGGCCCTCG: AAGGCCCTCGA
AAGGCCCTCGA: AGGCCCTCGAC
AGGCCCTCGAC: GGCCCTCGACA
GGCCCTCGACA: GCCCTCGACAT
GCCCTCGACAT: CCCTCGACATC
CCCTCGACATC: CCTCGACATCC
CCTCGACATCC: CTCGACATCCA
CTCGACATCCA: TCGACATCCAG
TCGACATCCAG: CGACATCCAGG
CGACATCCAGG: GACATCCAGGG
GACATCCAGGG: ACATCCAGGGC
ACATCCAGGGC: CATCCAGGGCA
CATCCAGGGCA: ATCCAGGGCAG
ATCCAGGGCAG: TCCAGGGCAGC
TCCAGGGCAGC: CCAGGGCAGCT
CCAGGGCAGCT: CAGGGCAGCTC
CAGGGCAGCTC: AGGGCAGCTCT
AGGGCAGCTCT: GGGCAGCTCTA
GGGCAGCTCTA: GGCAGCTCTAG
GGCAGCTCTAG: GCAGCTCTAGT
GCAGCTCTAGT: CAGCTCTAGTC
CAGCTCTAGTC: AGCTCTAGTCT
AGCTCTAGTCT: GCTCTAGTCTG
GCTCTAGTCTG: CTCTAGTCTGT
CTCTAGTCTGT: TCTAGTCTGTA
TCTAGTCTGTA: CTAGTCTGTAT
CTAGTCTGTAT: TAGTCTGTATG
TAGTCTGTATG: AGTCTGTATGG
AGTCTGTATGG: GTCTGTATGGC
GTCTGTATGGC: TCTGTATGGCT
TCTGTATGGCT: CTGTATGGCTT
CTGTATGGCTT: TGTATGGCTTC
TGTATGGCTTC: GTATGGCTTCC
GTATGGCTTCC: TATGGCTTCCT
TATGGCTTCCT: ATGGCTTCCTT
ATGGCTTCCTT: TGGCTTCCTTA
TGGCTTCCTTA: GGCTTCCTTAG
GGCTTCCTTAG: GCTTCCTTAGC
GCTTCCTTAGC: CTTCCTTAGCG
CTTCCTTAGCG: TTCCTTAGCGG
TTCCTTAGCGG: TCCTTAGCGGT
TCCTTAGCGGT: CCTTAGCGGTG
CCTTAGCGGTG: CTTAGCGGTGG
CTTAGCGGTGG: TTAGCGGTGGG
TTAGCGGTGGG: TAGCGGTGGGG
TAGCGGTGGGG: AGCGGTGGGGC
AGCGGTGGGGC: GCGGTGGGGCA
GCGGTGGGGCA: CGGTGGGGCAG
CGGTGGGGCAG: GGTGGGGCAGT
GGTGGGGCAGT: GTGGGGCAGTC
GTGGGGCAGTC: TGGGGCAGTCC
TGGGGCAGTCC: GGGGCAGTCCG
GGGGCAGTCCG: GGGCAGTCCGC
GGGCAGTCCGC: GGCAGTCCGCA
GGCAGTCCGCA: GCAGTCCGCAA
GCAGTCCGCAA: CAGTCCGCAAG
CAGTCCGCAAG: AGTCCGCAAGG
AGTCCGCAAGG: GTCCGCAAGGT
GTCCGCAAGGT: TCCGCAAGGTG
TCCGCAAGGTG: CCGCAAGGTGT
CCGCAAGGTGT: CGCAAGGTGTG
CGCAAGGTGTG: GCAAGGTGTGG
GCAAGGTGTGG: CAAGGTGTGGA
CAAGGTGTGGA: AAGGTGTGGAT
AAGGTGTGGAT: AGGTGTGGATT
AGGTGTGGATT: GGTGTGGATTT
GGTGTGGATTT: GTGTGGATTTA
GTGTGGATTTA: TGTGGATTTAT
TGTGGATTTAT: GTGGATTTATC
GTGGATTTATC: TGGATTTATCG
TGGATTTATCG: GGATTTATCGT
GGATTTATCGT: GATTTATCGTT
GATTTATCGTT: ATTTATCGTTC
ATTTATCGTTC: TTTATCGTTCT
TTTATCGTTCT: TTATCGTTCTC
TTATCGTTCTC: TATCGTTCTCC
TATCGTTCTCC: ATCGTTCTCCA
ATCGTTCTCCA: TCGTTCTCCAC
TCGTTCTCCAC: CGTTCTCCACG
CGTTCTCCACG: GTTCTCCACGG
GTTCTCCACGG: TTCTCCACGGT
TTCTCCACGGT: TCTCCACGGTG
TCTCCACGGTG: CTCCACGGTGT
CTCCACGGTGT: TCCACGGTGTT
TCCACGGTGTT: CCACGGTGTTT
CCACGGTGTTT: CACGGTGTTTA
CACGGTGTTTA: ACGGTGTTTAA
ACGGTGTTTAA: CGGTGTTTAAT
CGGTGTTTAAT: GGTGTTTAATT
GGTGTTTAATT: GTGTTTAATTT
GTGTTTAATTT: TGTTTAATTTT
TGTTTAATTTT: GTTTAATTTTG
GTTTAATTTTG: TTTAATTTTGT
TTTAATTTTGT: TTAATTTTGTA
TTAATTTTGTA: TAATTTTGTAC
TAATTTTGTAC: AATTTTGTACG
AATTTTGTACG: ATTTTGTACGA
ATTTTGTACGA: TTTTGTACGAC
TTTTGTACGAC: TTTGTACGACA
TTTGTACGACA: TTGTACGACAG
TTGTACGACAG: TGTACGACAGA
TGTACGACAGA: GTACGACAGAA
GTACGACAGAA: TACGACAGAAG
TACGACAGAAG: ACGACAGAAGT
ACGACAGAAGT: CGACAGAAGTG
CGACAGAAGTG: GACAGAAGTGG
GACAGAAGTGG: ACAGAAGTGGA
ACAGAAGTGGA: CAGAAGTGGAA
CAGAAGTGGAA: AGAAGTGGAAA
AGAAGTGGAAA: GAAGTGGAAAT
GAAGTGGAAAT: AAGTGGAAATT
AAGTGGAAATT: AGTGGAAATTT
AGTGGAAATTT: GTGGAAATTTC
GTGGAAATTTC: TGGAAATTTCG
TGGAAATTTCG: GGAAATTTCGC
GGAAATTTCGC: GAAATTTCGCT
GAAATTTCGCT: AAATTTCGCTT
AAATTTCGCTT: AATTTCGCTTG
AATTTCGCTTG: ATTTCGCTTGA
ATTTCGCTTGA: TTTCGCTTGAG
TTTCGCTTGAG: TTCGCTTGAGG
TTCGCTTGAGG: TCGCTTGAGGC
TCGCTTGAGGC: CGCTTGAGGCA
CGCTTGAGGCA: GCTTGAGGCAC
GCTTGAGGCAC: CTTGAGGCACT
CTTGAGGCACT: TTGAGGCACTT
TTGAGGCACTT: TGAGGCACTTT
TGAGGCACTTT: GAGGCACTTTC
GAGGCACTTTC: AGGCACTTTCT
AGGCACTTTCT: GGCACTTTCTG
GGCACTTTCTG: GCACTTTCTGC
GCACTTTCTGC: CACTTTCTGCT
CACTTTCTGCT: ACTTTCTGCTC
ACTTTCTGCTC: CTTTCTGCTCG
CTTTCTGCTCG: TTTCTGCTCGT
TTTCTGCTCGT: TTCTGCTCGTT
TTCTGCTCGTT: TCTGCTCGTTG
TCTGCTCGTTG: CTGCTCGTTGC
CTGCTCGTTGC: TGCTCGTTGCC
TGCTCGTTGCC: GCTCGTTGCCG
GCTCGTTGCCG: CTCGTTGCCGC
CTCGTTGCCGC: TCGTTGCCGCC
TCGTTGCCGCC: CGTTGCCGCCC
CGTTGCCGCCC: GTTGCCGCCCT
GTTGCCGCCCT: TTGCCGCCCTG
TTGCCGCCCTG: TGCCGCCCTGT
TGCCGCCCTGT: GCCGCCCTGTC
GCCGCCCTGTC: CCGCCCTGTCA
CCGCCCTGTCA: CGCCCTGTCAG
CGCCCTGTCAG: GCCCTGTCAGA
GCCCTGTCAGA: CCCTGTCAGAA
CCCTGTCAGAA: CCTGTCAGAAA
CCTGTCAGAAA: CTGTCAGAAAG
CTGTCAGAAAG: TGTCAGAAAGG
TGTCAGAAAGG: GTCAGAAAGGA
GTCAGAAAGGA: TCAGAAAGGAC
TCAGAAAGGAC: CAGAAAGGACG
CAGAAAGGACG: AGAAAGGACGT
AGAAAGGACGT: GAAAGGACGTC
GAAAGGACGTC: AAAGGACGTCG
AAAGGACGTCG: AAGGACGTCGA
AAGGACGTCGA: AGGACGTCGAA
AGGACGTCGAA: GGACGTCGAAA
GGACGTCGAAA: GACGTCGAAAA
GACGTCGAAAA: ACGTCGAAAAC
ACGTCGAAAAC: CGTCGAAAACT
CGTCGAAAACT: GTCGAAAACTT
GTCGAAAACTT: TCGAAAACTTA
TCGAAAACTTA: CGAAAACTTAG
CGAAAACTTAG: GAAAACTTAGG
GAAAACTTAGG: AAAACTTAGGG
AAAACTTAGGG: AAACTTAGGGC
AAACTTAGGGC: AACTTAGGGCT
AACTTAGGGCT: ACTTAGGGCTA
ACTTAGGGCTA: CTTAGGGCTAT
CTTAGGGCTAT: TTAGGGCTATC
TTAGGGCTATC: TAGGGCTATCA
TAGGGCTATCA: AGGGCTATCAG
AGGGCTATCAG: GGGCTATCAGT
GGGCTATCAGT: GGCTATCAGTA
GGCTATCAGTA: GCTATCAGTAG
GCTATCAGTAG: CTATCAGTAGG
CTATCAGTAGG: TATCAGTAGGT
TATCAGTAGGT: ATCAGTAGGTA
ATCAGTAGGTA: TCAGTAGGTAG
TCAGTAGGTAG: CAGTAGGTAGG
CAGTAGGTAGG: AGTAGGTAGGT
AGTAGGTAGGT: GTAGGTAGGTT
GTAGGTAGGTT: TAGGTAGGTTC
TAGGTAGGTTC: AGGTAGGTTCC
AGGTAGGTTCC: GGTAGGTTCCC
GGTAGGTTCCC: GTAGGTTCCCG
GTAGGTTCCCG: TAGGTTCCCGT
TAGGTTCCCGT: AGGTTCCCGTC
AGGTTCCCGTC: GGTTCCCGTCG
GGTTCCCGTCG: GTTCCCGTCGA
GTTCCCGTCGA: TTCCCGTCGAG
TTCCCGTCGAG: TCCCGTCGAGA
TCCCGTCGAGA: CCCGTCGAGAT
CCCGTCGAGAT: CCGTCGAGATT
CCGTCGAGATT: CGTCGAGATTG
CGTCGAGATTG: GTCGAGATTGA
GTCGAGATTGA: TCGAGATTGAG
TCGAGATTGAG: CGAGATTGAGT
CGAGATTGAGT: GAGATTGAGTA
GAGATTGAGTA: AGATTGAGTAA
AGATTGAGTAA: GATTGAGTAAG
GATTGAGTAAG: ATTGAGTAAGT
ATTGAGTAAGT: TTGAGTAAGTA
TTGAGTAAGTA: TGAGTAAGTAC
TGAGTAAGTAC: GAGTAAGTACT
GAGTAAGTACT: AGTAAGTACTA
AGTAAGTACTA: GTAAGTACTAG
GTAAGTACTAG: TAAGTACTAGG
TAAGTACTAGG: AAGTACTAGGC
AAGTACTAGGC: AGTACTAGGCG
AGTACTAGGCG: GTACTAGGCGG
GTACTAGGCGG: TACTAGGCGGC
TACTAGGCGGC: ACTAGGCGGCA
ACTAGGCGGCA: CTAGGCGGCAT
CTAGGCGGCAT: TAGGCGGCATG
TAGGCGGCATG: AGGCGGCATGA
AGGCGGCATGA: GGCGGCATGAG
GGCGGCATGAG: GCGGCATGAGA
GCGGCATGAGA: CGGCATGAGAT
CGGCATGAGAT: GGCATGAGATG
GGCATGAGATG: GCATGAGATGA
GCATGAGATGA: CATGAGATGAC
CATGAGATGAC: ATGAGATGACA
ATGAGATGACA: TGAGATGACAC
TGAGATGACAC: GAGATGACACT
GAGATGACACT: AGATGACACTA
AGATGACACTA: GATGACACTAC
GATGACACTAC: ATGACACTACA
ATGACACTACA: TGACACTACAC
TGACACTACAC: GACACTACACC
GACACTACACC: ACACTACACCC
ACACTACACCC: CACTACACCCT
CACTACACCCT: ACTACACCCTC
ACTACACCCTC: CTACACCCTCG
CTACACCCTCG: TACACCCTCGC
TACACCCTCGC: ACACCCTCGCA
ACACCCTCGCA: CACCCTCGCAC
CACCCTCGCAC: ACCCTCGCACA
ACCCTCGCACA: CCCTCGCACAG
CCCTCGCACAG: CCTCGCACAGT
CCTCGCACAGT: CTCGCACAGTT
CTCGCACAGTT: TCGCACAGTTG
TCGCACAGTTG: CGCACAGTTGC
CGCACAGTTGC: GCACAGTTGCA
GCACAGTTGCA: CACAGTTGCAA
CACAGTTGCAA: ACAGTTGCAAG
ACAGTTGCAAG: CAGTTGCAAGA
CAGTTGCAAGA: AGTTGCAAGAA
AGTTGCAAGAA: GTTGCAAGAAA
GTTGCAAGAAA: TTGCAAGAAAA
TTGCAAGAAAA: TGCAAGAAAAT
TGCAAGAAAAT: GCAAGAAAATC
GCAAGAAAATC: CAAGAAAATCT
CAAGAAAATCT: AAGAAAATCTT
AAGAAAATCTT: AGAAAATCTTC
AGAAAATCTTC: GAAAATCTTCA
GAAAATCTTCA: AAAATCTTCAC
AAAATCTTCAC: AAATCTTCACT
AAATCTTCACT: AATCTTCACTT
AATCTTCACTT: ATCTTCACTTG
ATCTTCACTTG: TCTTCACTTGC
TCTTCACTTGC: CTTCACTTGCG
CTTCACTTGCG: TTCACTTGCGC
TTCACTTGCGC: TCACTTGCGCC
TCACTTGCGCC: CACTTGCGCCA
CACTTGCGCCA: ACTTGCGCCAT
ACTTGCGCCAT: CTTGCGCCATC
CTTGCGCCATC: TTGCGCCATCG
TTGCGCCATCG: TGCGCCATCGT
TGCGCCATCGT: GCGCCATCGTT
GCGCCATCGTT: CGCCATCGTTA
CGCCATCGTTA: GCCATCGTTAC
GCCATCGTTAC: CCATCGTTACA
CCATCGTTACA: CATCGTTACAA
CATCGTTACAA: ATCGTTACAAG
ATCGTTACAAG: TCGTTACAAGT
TCGTTACAAGT: CGTTACAAGTG
CGTTACAAGTG: GTTACAAGTGA
GTTACAAGTGA: TTACAAGTGAC
TTACAAGTGAC: TACAAGTGACT
TACAAGTGACT: ACAAGTGACTG
ACAAGTGACTG: CAAGTGACTGT
CAAGTGACTGT: AAGTGACTGTG
AAGTGACTGTG: AGTGACTGTGA
AGTGACTGTGA: GTGACTGTGAA
GTGACTGTGAA: TGACTGTGAAG
TGACTGTGAAG: GACTGTGAAGG
GACTGTGAAGG: ACTGTGAAGGT
ACTGTGAAGGT: CTGTGAAGGTT
CTGTGAAGGTT: TGTGAAGGTTT
TGTGAAGGTTT: GTGAAGGTTTA
GTGAAGGTTTA: TGAAGGTTTAG
TGAAGGTTTAG: GAAGGTTTAGG
GAAGGTTTAGG: AAGGTTTAGGG
AAGGTTTAGGG: AGGTTTAGGGC
AGGTTTAGGGC: GGTTTAGGGCA
GGTTTAGGGCA: GTTTAGGGCAC
GTTTAGGGCAC: TTTAGGGCACG
TTTAGGGCACG: TTAGGGCACGG