AAAAAGCCCAATATGCGAG: AAAAGCCCAATATGCGAGT
AAAAGCCCAATATGCGAGT: AAAGCCCAATATGCGAGTG
AAAAGTAAGCCTGCTCGCA: AAAGTAAGCCTGCTCGCAC
AAAATTGACTCGATTGAGC: AAATTGACTCGATTGAGCA
AAAATTGCTTCGAGGAGGA: AAATTGCTTCGAGGAGGAC
AAACAGAAATTTCAGATCA: AACAGAAATTTCAGATCAT
AAACCAGGCTAGGCGTTTG: AACCAGGCTAGGCGTTTGT
AAACCTATACCCAGCACTG: AACCTATACCCAGCACTGG AACCTATACCCAGCACTGG
AAACCTATCGCATGCGTGT: AACCTATCGCATGCGTGTT
AAACTTCGATGTGCCCCAC: AACTTCGATGTGCCCCACC
AAACTTTGTGTCAATCCGC: AACTTTGTGTCAATCCGCC
AAAGAATTGCATGCGCTGA: AAGAATTGCATGCGCTGAA
AAAGCCCAATATGCGAGTG: AAGCCCAATATGCGAGTGA
AAAGCTAGTTCGCCGTATA: AAGCTAGTTCGCCGTATAC
AAAGCTGCGTAGACAAATA: AAGCTGCGTAGACAAATAC
AAAGGTACGTTCAAGTATG: AAGGTACGTTCAAGTATGG
AAAGTAAGCCTGCTCGCAC: AAGTAAGCCTGCTCGCACG
AAAGTCGCTATTAGGGTAG: AAGTCGCTATTAGGGTAGG
AAAGTTGAGCAACCCGCGC: AAGTTGAGCAACCCGCGCT
AAAGTTTTCCAGCAAGAGT: AAGTTTTCCAGCAAGAGTC
AAATACAAGCTAGCCAATG: AATACAAGCTAGCCAATGT
AAATACTTACATCATAGAT: AATACTTACATCATAGATG
AAATCATCGGGCGTGTGCT: AATCATCGGGCGTGTGCTG
AAATCCTGCGGGCTTCCTA: AATCCTGCGGGCTTCCTAT
AAATGTCGGAAATCCTGCG: AATGTCGGAAATCCTGCGG
AAATTGACTCGATTGAGCA: AATTGACTCGATTGAGCAT
AAATTGCTTCGAGGAGGAC: AATTGCTTCGAGGAGGACC
AAATTTCAGATCATTGTCA: AATTTCAGATCATTGTCAG
AAATTTGAGAACGTCACTT: AATTTGAGAACGTCACTTA
AACACTTGCAGATAATTAT: ACACTTGCAGATAATTATG
AACAGAAATTTCAGATCAT: ACAGAAATTTCAGATCATT
AACAGAGCTCATTCTAACG: ACAGAGCTCATTCTAACGT
AACAGCACCTGGCAAATTT: ACAGCACCTGGCAAATTTG
AACAGGACCTGTAGCTAGG: ACAGGACCTGTAGCTAGGG
AACAGTATAGTCGATGATC: ACAGTATAGTCGATGATCT
AACAGTTAGATAGTATCTG: ACAGTTAGATAGTATCTGG
AACATCAGAGCGCAGCTAA: ACATCAGAGCGCAGCTAAG
AACATGTAGACACGGCCAT: ACATGTAGACACGGCCATC
AACATGTCAGAAAAGTAAG: ACATGTCAGAAAAGTAAGC
AACCAACATCAGAGCGCAG: ACCAACATCAGAGCGCAGC
AACCACTTTAGTTGGCCCT: ACCACTTTAGTTGGCCCTA
AACCAGGCTAGGCGTTTGT: ACCAGGCTAGGCGTTTGTC
AACCATTTTTACTTCGCAG: ACCATTTTTACTTCGCAGC
AACCCGCGCTCAGATCTGA: ACCCGCGCTCAGATCTGAC
AACCTATACCCAGCACTGG: ACCTATACCCAGCACTGGA ACCTATACCCAGCACTGGT ACCTATACCCAGCACTGGT ACCTATACCCAGCACTGGT
AACCTATCGCATGCGTGTT: ACCTATCGCATGCGTGTTG
AACGACATTGGTGCACCTG: ACGACATTGGTGCACCTGT
AACGCTGTAAGACAGCACG: ACGCTGTAAGACAGCACGG
AACGTAAACAGAAATTTCA: ACGTAAACAGAAATTTCAG
AACGTACCAATGCCCTACC: ACGTACCAATGCCCTACCC
AACGTCACTTAAACCAGGC: ACGTCACTTAAACCAGGCT
AACGTTCTTCATTGTCCTT: ACGTTCTTCATTGTCCTTG
AACTAGACCCGATGCCTGA: ACTAGACCCGATGCCTGAT
AACTGAAAGGTACGTTCAA: ACTGAAAGGTACGTTCAAG
AACTGAAGCGTTCACTTAG: ACTGAAGCGTTCACTTAGA
AACTTCGATGTGCCCCACC: ACTTCGATGTGCCCCACCT
AACTTGATGGTCGCCGCGT: ACTTGATGGTCGCCGCGTA
AACTTTGTGTCAATCCGCC: ACTTTGTGTCAATCCGCCC
AAGAAAAAGCCCAATATGC: AGAAAAAGCCCAATATGCG
AAGAACCTATACCCAGCAC: AGAACCTATACCCAGCACT
AAGAACGTACCAATGCCCT: AGAACGTACCAATGCCCTA
AAGAAGAACGTACCAATGC: AGAAGAACGTACCAATGCC
AAGAATCGGGGAGACTAGG: AGAATCGGGGAGACTAGGC
AAGAATTGCATGCGCTGAA: AGAATTGCATGCGCTGAAA
AAGACAGCACGGACCAATG: AGACAGCACGGACCAATGT
AAGAGTCTGTGTATTAATC: AGAGTCTGTGTATTAATCA
AAGATGTAACTGAAGCGTT: AGATGTAACTGAAGCGTTC
AAGATTTCGATCAGTCGAG: AGATTTCGATCAGTCGAGT
AAGCAAAATTGACTCGATT: AGCAAAATTGACTCGATTG
AAGCAATAGATCGGGAAGA: AGCAATAGATCGGGAAGAT
AAGCATTTGGTGAGGGTGA: AGCATTTGGTGAGGGTGAG
AAGCCCAATATGCGAGTGA: AGCCCAATATGCGAGTGAG
AAGCCTGCTCGCACGTTTT: AGCCTGCTCGCACGTTTTG
AAGCGGTAACATGTAGACA: AGCGGTAACATGTAGACAC
AAGCGTTCACTTAGAGTGC: AGCGTTCACTTAGAGTGCA
AAGCTAGCCAATGTGTTGC: AGCTAGCCAATGTGTTGCG
AAGCTAGTTCGCCGTATAC: AGCTAGTTCGCCGTATACA
AAGCTGCGTAGACAAATAC: AGCTGCGTAGACAAATACT
AAGGAATCTGGGCAACACT: AGGAATCTGGGCAACACTT
AAGGCGTGGTTTGCAGAAT: AGGCGTGGTTTGCAGAATG
AAGGGGGCAAAGTTTTCCA: AGGGGGCAAAGTTTTCCAG
AAGGGTTATCCGACCACGT: AGGGTTATCCGACCACGTG
AAGGTACGTTCAAGTATGG: AGGTACGTTCAAGTATGGG
AAGGTTGGGAGTCTCACAA: AGGTTGGGAGTCTCACAAG
AAGTAAGCCTGCTCGCACG: AGTAAGCCTGCTCGCACGT
AAGTATAAGATTTCGATCA: AGTATAAGATTTCGATCAG
AAGTATACTCTGTACTGGC: AGTATACTCTGTACTGGCA
AAGTATGGGACACTTATAG: AGTATGGGACACTTATAGG
AAGTCGCTATTAGGGTAGG: AGTCGCTATTAGGGTAGGC
AAGTTGAGCAACCCGCGCT: AGTTGAGCAACCCGCGCTC
AAGTTTTCCAGCAAGAGTC: AGTTTTCCAGCAAGAGTCT
AATACAAGCTAGCCAATGT: ATACAAGCTAGCCAATGTG
AATACTTACATCATAGATG: ATACTTACATCATAGATGG
AATAGATCGGGAAGATGTA: ATAGATCGGGAAGATGTAA
AATAGTCCACTCTAATTCA: ATAGTCCACTCTAATTCAA
AATATCGCGTCACATTCTT: ATATCGCGTCACATTCTTG
AATATGCGAGTGAGGTGTC: ATATGCGAGTGAGGTGTCC
AATCACCGTCTGATAAGGG: ATCACCGTCTGATAAGGGT
AATCAGTTGAAAGTCGCTA: ATCAGTTGAAAGTCGCTAT
AATCATCGGGCGTGTGCTG: ATCATCGGGCGTGTGCTGC
AATCCGCCCCGAGACATAT: ATCCGCCCCGAGACATATT
AATCCTGCGGGCTTCCTAT: ATCCTGCGGGCTTCCTATC
AATCGGATCCTTCGCTGGA: ATCGGATCCTTCGCTGGAT
AATCGGGGAGACTAGGCTT: ATCGGGGAGACTAGGCTTT
AATCGTCTCGCGTGGGGCG: ATCGTCTCGCGTGGGGCGG
AATCTCGCTTTGGCTAATT: ATCTCGCTTTGGCTAATTT
AATCTGGGCAACACTTGCA: ATCTGGGCAACACTTGCAG
AATGAAACCTATACCCAGC: ATGAAACCTATACCCAGCA
AATGATAAGAATCGGGGAG: ATGATAAGAATCGGGGAGA
AATGATCGTGTATCGTTAG: ATGATCGTGTATCGTTAGG
AATGCCCTACCCGGTATAT: ATGCCCTACCCGGTATATC
AATGGCACTTACGCTTCTC: ATGGCACTTACGCTTCTCG
AATGTCGGAAATCCTGCGG: ATGTCGGAAATCCTGCGGG
AATGTGTTGCGCGCACCGT: ATGTGTTGCGCGCACCGTT
AATGTTTCGGCGAATGATA: ATGTTTCGGCGAATGATAA
AATTATCACCGCCTCGGAC: ATTATCACCGCCTCGGACT
AATTATGAGTCAAACCTAT: ATTATGAGTCAAACCTATC
AATTCAATCGGATCCTTCG: ATTCAATCGGATCCTTCGC
AATTCAGAGCACGAAAATT: ATTCAGAGCACGAAAATTG
AATTGACTCGATTGAGCAT: ATTGACTCGATTGAGCATA
AATTGCATGCGCTGAAATG: ATTGCATGCGCTGAAATGT
AATTGCTTCGAGGAGGACC: ATTGCTTCGAGGAGGACCA
AATTGTGTTTCTCAGTCAG: ATTGTGTTTCTCAGTCAGG
AATTTCAGATCATTGTCAG: ATTTCAGATCATTGTCAGA
AATTTCTGACTGGTATCTA: ATTTCTGACTGGTATCTAG
AATTTGAGAACGTCACTTA: ATTTGAGAACGTCACTTAA
ACAAATACTTACATCATAG: CAAATACTTACATCATAGA
ACAAGCTAGCCAATGTGTT: CAAGCTAGCCAATGTGTTG
ACAAGGCGTGGTTTGCAGA: CAAGGCGTGGTTTGCAGAA
ACAAGTATAAGATTTCGAT: CAAGTATAAGATTTCGATC
ACAATTATCACCGCCTCGG: CAATTATCACCGCCTCGGA
ACACGGCCATCTCCTAGTA: CACGGCCATCTCCTAGTAG
ACACTTATAGGGGCCGCTT: CACTTATAGGGGCCGCTTA
ACACTTGCAGATAATTATG: CACTTGCAGATAATTATGA
ACAGAAATTTCAGATCATT: CAGAAATTTCAGATCATTG
ACAGAGCTCATTCTAACGT: CAGAGCTCATTCTAACGTA
ACAGCACCTGGCAAATTTG: CAGCACCTGGCAAATTTGA
ACAGCACGGACCAATGTTT: CAGCACGGACCAATGTTTC
ACAGCGAAGCAATAGATCG: CAGCGAAGCAATAGATCGG
ACAGCGCTACAGTCAGCGC: CAGCGCTACAGTCAGCGCC
ACAGGACCTGTAGCTAGGG: CAGGACCTGTAGCTAGGGA
ACAGTATAGTCGATGATCT: CAGTATAGTCGATGATCTA
ACAGTCAGCGCCCCGGATC: CAGTCAGCGCCCCGGATCC
ACAGTTAGATAGTATCTGG: CAGTTAGATAGTATCTGGA
ACATATTCCCAGTTGATTA: CATATTCCCAGTTGATTAG
ACATCAGAGCGCAGCTAAG: CATCAGAGCGCAGCTAAGA
ACATCATAGATGGCGTCTG: CATCATAGATGGCGTCTGG
ACATGCGTCATTGATGACG: CATGCGTCATTGATGACGA
ACATGGGTAGAACAGGACC: CATGGGTAGAACAGGACCT
ACATGTAGACACGGCCATC: CATGTAGACACGGCCATCT
ACATGTCAGAAAAGTAAGC: CATGTCAGAAAAGTAAGCC
ACATTCTTGAATGATCGTG: CATTCTTGAATGATCGTGT
ACATTGGTGCACCTGTATC: CATTGGTGCACCTGTATCT
ACCAACATCAGAGCGCAGC: CCAACATCAGAGCGCAGCT
ACCAAGGGGGCAAAGTTTT: CCAAGGGGGCAAAGTTTTC
ACCAATGCCCTACCCGGTA: CCAATGCCCTACCCGGTAT
ACCAATGTTTCGGCGAATG: CCAATGTTTCGGCGAATGA
ACCACGTGGCGTAGCGCCT: CCACGTGGCGTAGCGCCTC
ACCACTTTAGTTGGCCCTA: CCACTTTAGTTGGCCCTAT
ACCAGGCTAGGCGTTTGTC: CCAGGCTAGGCGTTTGTCC
ACCATGATGTTCGACCCCA: CCATGATGTTCGACCCCAA
ACCATTTTTACTTCGCAGC: CCATTTTTACTTCGCAGCC
ACCCAGCACTGGATCAGTC: CCCAGCACTGGATCAGTCT
ACCCAGCACTGGTCATTAG: CCCAGCACTGGTCATTAGG
ACCCAGCACTGGTCTGGTG: CCCAGCACTGGTCTGGTGA
ACCCAGCACTGGTTCCGTT: CCCAGCACTGGTTCCGTTA
ACCCCAATCGTCTCGCGTG: CCCCAATCGTCTCGCGTGG
ACCCCATAAGGAATCTGGG: CCCCATAAGGAATCTGGGC
ACCCGATGCCTGATCACGC: CCCGATGCCTGATCACGCC
ACCCGCGCTCAGATCTGAC: CCCGCGCTCAGATCTGACG
ACCCGGTATATCGTTAGAG: CCCGGTATATCGTTAGAGT
ACCGACTCTTGTGACCCCA: CCGACTCTTGTGACCCCAT
ACCGCCTCGGACTCCAGCG: CCGCCTCGGACTCCAGCGA
ACCGTACGGGATGGGGTTA: CCGTACGGGATGGGGTTAT
ACCGTCTGATAAGGGTTAT: CCGTCTGATAAGGGTTATC
ACCGTTCGGATCTGCCCCA: CCGTTCGGATCTGCCCCAG
ACCTATACCCAGCACTGGA: CCTATACCCAGCACTGGAT
ACCTATACCCAGCACTGGT: CCTATACCCAGCACTGGTC CCTATACCCAGCACTGGTC CCTATACCCAGCACTGGTT
ACCTATCGCATGCGTGTTG: CCTATCGCATGCGTGTTGA
ACCTGGCAAATTTGAGAAC: CCTGGCAAATTTGAGAACG
ACCTGTAGCTAGGGACGAC: CCTGTAGCTAGGGACGACG
ACCTGTATCTCGAAACTTC: CCTGTATCTCGAAACTTCG
ACCTTATTACATGCGTCAT: CCTTATTACATGCGTCATT
ACCTTGAGGAGCTTACCAT: CCTTGAGGAGCTTACCATG
ACCTTTGATTCGCAATGAA: CCTTTGATTCGCAATGAAA
ACCTTTGCGCTGCGCAAGA: CCTTTGCGCTGCGCAAGAA
ACCTTTGGACTGGGCGTAA: CCTTTGGACTGGGCGTAAA
ACCTTTGTTCGGGACTTTA: CCTTTGTTCGGGACTTTAA
ACGAAAATTGCTTCGAGGA: CGAAAATTGCTTCGAGGAG
ACGAAAGCTGCGTAGACAA: CGAAAGCTGCGTAGACAAA
ACGAACAGCACCTGGCAAA: CGAACAGCACCTGGCAAAT
ACGACATTGGTGCACCTGT: CGACATTGGTGCACCTGTA
ACGACGATGGTATTAGAGC: CGACGATGGTATTAGAGCT
ACGAGAAGGTTGGGAGTCT: CGAGAAGGTTGGGAGTCTC
ACGAGTGAGCGATGTGCCC: CGAGTGAGCGATGTGCCCC
ACGATGTGCCCCACCTTTG: CGATGTGCCCCACCTTTGA
ACGCCACGAGTGAGCGATG: CGCCACGAGTGAGCGATGT
ACGCTGTAAGACAGCACGG: CGCTGTAAGACAGCACGGA
ACGCTTCTCGATCGCTGTC: CGCTTCTCGATCGCTGTCC
ACGGACCAATGTTTCGGCG: CGGACCAATGTTTCGGCGA
ACGGCCATCTCCTAGTAGC: CGGCCATCTCCTAGTAGCA
ACGGGATGGGGTTATTTTG: CGGGATGGGGTTATTTTGC
ACGGTTTGGTTCTCTCACC: CGGTTTGGTTCTCTCACCG
ACGTAAACAGAAATTTCAG: CGTAAACAGAAATTTCAGA
ACGTACCAATGCCCTACCC: CGTACCAATGCCCTACCCG
ACGTAGTCATCAACATGTC: CGTAGTCATCAACATGTCA
ACGTCACTTAAACCAGGCT: CGTCACTTAAACCAGGCTA
ACGTGGCGTAGCGCCTCCT: CGTGGCGTAGCGCCTCCTA
ACGTTCAAGTATGGGACAC: CGTTCAAGTATGGGACACT
ACGTTCTTCATTGTCCTTG: CGTTCTTCATTGTCCTTGC
ACGTTTTGTCCAGCGTGAC: CGTTTTGTCCAGCGTGACA
ACTAGACCCGATGCCTGAT: CTAGACCCGATGCCTGATC
ACTAGGCTTTTGAAGCAAA: CTAGGCTTTTGAAGCAAAA
ACTCCAGCGACGGTTTGGT: CTCCAGCGACGGTTTGGTT
ACTCCCAGTTCAACTTGAT: CTCCCAGTTCAACTTGATG
ACTCGATTGAGCATATTGA: CTCGATTGAGCATATTGAA
ACTCTAATTCAATCGGATC: CTCTAATTCAATCGGATCC
ACTCTGTACTGGCATGCTA: CTCTGTACTGGCATGCTAA
ACTCTTGTGACCCCATAAG: CTCTTGTGACCCCATAAGG
ACTGAAAGGTACGTTCAAG: CTGAAAGGTACGTTCAAGT
ACTGAAGCGTTCACTTAGA: CTGAAGCGTTCACTTAGAG
ACTGCGTGCAAGCATTTGG: CTGCGTGCAAGCATTTGGT
ACTGGATCAGTCTCGTTTG: CTGGATCAGTCTCGTTTGG
ACTGGCATGCTAACTGAAA: CTGGCATGCTAACTGAAAG
ACTGGGCGTAAACCTATAC: CTGGGCGTAAACCTATACC
ACTGGTATCTAGAAGTATA: CTGGTATCTAGAAGTATAC
ACTGGTCATTAGGCAGTCT: CTGGTCATTAGGCAGTCTT
ACTGGTCTGGTGAAATACA: CTGGTCTGGTGAAATACAA
ACTGGTTCCGTTACGAAAG: CTGGTTCCGTTACGAAAGC
ACTTAAACCAGGCTAGGCG: CTTAAACCAGGCTAGGCGT
ACTTACATCATAGATGGCG: CTTACATCATAGATGGCGT
ACTTACGCTTCTCGATCGC: CTTACGCTTCTCGATCGCT
ACTTAGAGTGCAGCATTAT: CTTAGAGTGCAGCATTATC
ACTTATAGGGGCCGCTTAG: CTTATAGGGGCCGCTTAGT
ACTTCCATCGACGAACAGC: CTTCCATCGACGAACAGCA
ACTTCGATGTGCCCCACCT: CTTCGATGTGCCCCACCTT
ACTTCGCAGCCCGCGGATC: CTTCGCAGCCCGCGGATCT
ACTTGATGGTCGCCGCGTA: CTTGATGGTCGCCGCGTAA
ACTTGCAGATAATTATGAG: CTTGCAGATAATTATGAGT
ACTTGGTGCCGCTTCGTAG: CTTGGTGCCGCTTCGTAGC
ACTTTAACCTATACCCAGC: CTTTAACCTATACCCAGCA
ACTTTAGTTGGCCCTATAT: CTTTAGTTGGCCCTATATA
ACTTTGTGTCAATCCGCCC: CTTTGTGTCAATCCGCCCC
AGAAAAAGCCCAATATGCG: GAAAAAGCCCAATATGCGA
AGAAAAGTAAGCCTGCTCG: GAAAAGTAAGCCTGCTCGC
AGAAATTTCAGATCATTGT: GAAATTTCAGATCATTGTC
AGAACAGGACCTGTAGCTA: GAACAGGACCTGTAGCTAG
AGAACCTATACCCAGCACT: GAACCTATACCCAGCACTG
AGAACGTACCAATGCCCTA: GAACGTACCAATGCCCTAC
AGAACGTCACTTAAACCAG: GAACGTCACTTAAACCAGG
AGAAGAACGTACCAATGCC: GAAGAACGTACCAATGCCC
AGAAGGTTGGGAGTCTCAC: GAAGGTTGGGAGTCTCACA
AGAAGTATACTCTGTACTG: GAAGTATACTCTGTACTGG
AGAATCGGGGAGACTAGGC: GAATCGGGGAGACTAGGCT
AGAATGGCACTTACGCTTC: GAATGGCACTTACGCTTCT
AGAATTGCATGCGCTGAAA: GAATTGCATGCGCTGAAAT
AGACAAATACTTACATCAT: GACAAATACTTACATCATA
AGACACGGCCATCTCCTAG: GACACGGCCATCTCCTAGT
AGACAGCACGGACCAATGT: GACAGCACGGACCAATGTT
AGACATATTCCCAGTTGAT: GACATATTCCCAGTTGATT
AGACCCGATGCCTGATCAC: GACCCGATGCCTGATCACG
AGACTAGGCTTTTGAAGCA: GACTAGGCTTTTGAAGCAA
AGAGCACGAAAATTGCTTC: GAGCACGAAAATTGCTTCG
AGAGCGCAGCTAAGAAGAA: GAGCGCAGCTAAGAAGAAC
AGAGCTCATTCTAACGTAA: GAGCTCATTCTAACGTAAA
AGAGGCAACGACATTGGTG: GAGGCAACGACATTGGTGC
AGAGTCCCACAGCGCTACA: GAGTCCCACAGCGCTACAG
AGAGTCTAACGTTCTTCAT: GAGTCTAACGTTCTTCATT
AGAGTCTGTGTATTAATCA: GAGTCTGTGTATTAATCAG
AGAGTGCAGCATTATCCTG: GAGTGCAGCATTATCCTGA
AGATAATTATGAGTCAAAC: GATAATTATGAGTCAAACC
AGATAGTATCTGGAAATCA: GATAGTATCTGGAAATCAT
AGATCATTGTCAGATTCCA: GATCATTGTCAGATTCCAG
AGATCGCTTGGCTTCAGTC: GATCGCTTGGCTTCAGTCC
AGATCGGGAAGATGTAACT: GATCGGGAAGATGTAACTG
AGATCTGACGTAGTCATCA: GATCTGACGTAGTCATCAA
AGATGGCGTCTGGTTGGTA: GATGGCGTCTGGTTGGTAT
AGATGTAACTGAAGCGTTC: GATGTAACTGAAGCGTTCA
AGATGTTGGAGCGCGAGAG: GATGTTGGAGCGCGAGAGG
AGATTCCAGCGTTTAGGGC: GATTCCAGCGTTTAGGGCA
AGATTTCGATCAGTCGAGT: GATTTCGATCAGTCGAGTA
AGCAAAATTGACTCGATTG: GCAAAATTGACTCGATTGA
AGCAAACTTTGTGTCAATC: GCAAACTTTGTGTCAATCC
AGCAACCCGCGCTCAGATC: GCAACCCGCGCTCAGATCT
AGCAAGAGTCTGTGTATTA: GCAAGAGTCTGTGTATTAA
AGCAATAGATCGGGAAGAT: GCAATAGATCGGGAAGATG
AGCAATTGTGTTTCTCAGT: GCAATTGTGTTTCTCAGTC
AGCACCTGGCAAATTTGAG: GCACCTGGCAAATTTGAGA
AGCACGAAAATTGCTTCGA: GCACGAAAATTGCTTCGAG
AGCACGGACCAATGTTTCG: GCACGGACCAATGTTTCGG
AGCACTGGATCAGTCTCGT: GCACTGGATCAGTCTCGTT
AGCACTGGTCATTAGGCAG: GCACTGGTCATTAGGCAGT
AGCACTGGTCTGGTGAAAT: GCACTGGTCTGGTGAAATA
AGCACTGGTTCCGTTACGA: GCACTGGTTCCGTTACGAA
AGCATATTGAAGCGGTAAC: GCATATTGAAGCGGTAACA
AGCATTATCCTGAACCACT: GCATTATCCTGAACCACTT
AGCATTTGGTGAGGGTGAG: GCATTTGGTGAGGGTGAGT
AGCCAATGTGTTGCGCGCA: GCCAATGTGTTGCGCGCAC
AGCCCAATATGCGAGTGAG: GCCCAATATGCGAGTGAGG
AGCCCGCGGATCTACCGTA: GCCCGCGGATCTACCGTAC
AGCCCGTAACGCTGTAAGA: GCCCGTAACGCTGTAAGAC
AGCCTGCTCGCACGTTTTG: GCCTGCTCGCACGTTTTGT
AGCGAAGCAATAGATCGGG: GCGAAGCAATAGATCGGGA
AGCGACGGTTTGGTTCTCT: GCGACGGTTTGGTTCTCTC
AGCGATGTGCCCCACCTTT: GCGATGTGCCCCACCTTTG
AGCGCAGCTAAGAAGAACG: GCGCAGCTAAGAAGAACGT
AGCGCCCCGGATCCGATCG: GCGCCCCGGATCCGATCGG
AGCGCCTCCTATCTTTTCT: GCGCCTCCTATCTTTTCTA
AGCGCGAGAGGCAACGACA: GCGCGAGAGGCAACGACAT
AGCGCTACAGTCAGCGCCC: GCGCTACAGTCAGCGCCCC
AGCGGTAACATGTAGACAC: GCGGTAACATGTAGACACG
AGCGTGACATGGGTAGAAC: GCGTGACATGGGTAGAACA
AGCGTTCACTTAGAGTGCA: GCGTTCACTTAGAGTGCAG
AGCGTTTAGGGCAGCTCAC: GCGTTTAGGGCAGCTCACA
AGCTAAGAAGAACGTACCA: GCTAAGAAGAACGTACCAA
AGCTAGCCAATGTGTTGCG: GCTAGCCAATGTGTTGCGC
AGCTAGGGACGACGATGGT: GCTAGGGACGACGATGGTA
AGCTAGTTCGCCGTATACA: GCTAGTTCGCCGTATACAA
AGCTCACAATTATCACCGC: GCTCACAATTATCACCGCC
AGCTCATTCTAACGTAAAC: GCTCATTCTAACGTAAACA
AGCTCCACTTGGTGCCGCT: GCTCCACTTGGTGCCGCTT
AGCTCGCAGTTTAATTCAG: GCTCGCAGTTTAATTCAGA
AGCTGCGTAGACAAATACT: GCTGCGTAGACAAATACTT
AGCTTACCATGATGTTCGA: GCTTACCATGATGTTCGAC
AGCTTTGAGATCGCTTGGC: GCTTTGAGATCGCTTGGCT
AGGAACAGTTAGATAGTAT: GGAACAGTTAGATAGTATC
AGGAATCTGGGCAACACTT: GGAATCTGGGCAACACTTG
AGGACCAAGGGGGCAAAGT: GGACCAAGGGGGCAAAGTT
AGGACCTGTAGCTAGGGAC: GGACCTGTAGCTAGGGACG
AGGAGCTTACCATGATGTT: GGAGCTTACCATGATGTTC
AGGAGGACCAAGGGGGCAA: GGAGGACCAAGGGGGCAAA
AGGCAACCATTTTTACTTC: GGCAACCATTTTTACTTCG
AGGCAACGACATTGGTGCA: GGCAACGACATTGGTGCAC
AGGCAGTCTTGGTCGCTTA: GGCAGTCTTGGTCGCTTAG
AGGCGTGGTTTGCAGAATG: GGCGTGGTTTGCAGAATGG
AGGCGTTTGTCCCTATGGA: GGCGTTTGTCCCTATGGAA
AGGCTAAGAAAAAGCCCAA: GGCTAAGAAAAAGCCCAAT
AGGCTAGGCGTTTGTCCCT: GGCTAGGCGTTTGTCCCTA
AGGCTTTTGAAGCAAAATT: GGCTTTTGAAGCAAAATTG
AGGGACGACGATGGTATTA: GGGACGACGATGGTATTAG
AGGGCAGCTCACAATTATC: GGGCAGCTCACAATTATCA
AGGGGCCGCTTAGTCATCG: GGGGCCGCTTAGTCATCGC
AGGGGGCAAAGTTTTCCAG: GGGGGCAAAGTTTTCCAGC
AGGGTAGGCAACCATTTTT: GGGTAGGCAACCATTTTTA
AGGGTCTGTGACAGCGAAG: GGGTCTGTGACAGCGAAGC
AGGGTGAGTAGTGTTTCAA: GGGTGAGTAGTGTTTCAAA
AGGGTTATCCGACCACGTG: GGGTTATCCGACCACGTGG
AGGGTTCGCTCAACTAGAC: GGGTTCGCTCAACTAGACC
AGGTACGTTCAAGTATGGG: GGTACGTTCAAGTATGGGA
AGGTCCATACGAGAAGGTT: GGTCCATACGAGAAGGTTG
AGGTGTCCGGTTCGAACAG: GGTGTCCGGTTCGAACAGT
AGGTTGGGAGTCTCACAAG: GGTTGGGAGTCTCACAAGT
AGTAACCAACATCAGAGCG: GTAACCAACATCAGAGCGC
AGTAAGCCTGCTCGCACGT: GTAAGCCTGCTCGCACGTT
AGTAGCAAACTTTGTGTCA: GTAGCAAACTTTGTGTCAA
AGTAGTGTTTCAAAGAATT: GTAGTGTTTCAAAGAATTG
AGTATAAGATTTCGATCAG: GTATAAGATTTCGATCAGT
AGTATACTCTGTACTGGCA: GTATACTCTGTACTGGCAT
AGTATAGTCGATGATCTAA: GTATAGTCGATGATCTAAT
AGTATCTGGAAATCATCGG: GTATCTGGAAATCATCGGG
AGTATGGGACACTTATAGG: GTATGGGACACTTATAGGG
AGTCAAACCTATCGCATGC: GTCAAACCTATCGCATGCG
AGTCAGCGCCCCGGATCCG: GTCAGCGCCCCGGATCCGA
AGTCAGGGTTCGCTCAACT: GTCAGGGTTCGCTCAACTA
AGTCATCAACATGTCAGAA: GTCATCAACATGTCAGAAA
AGTCATCGCTGAGGTCCAT: GTCATCGCTGAGGTCCATA
AGTCCACTCTAATTCAATC: GTCCACTCTAATTCAATCG
AGTCCCACAGCGCTACAGT: GTCCCACAGCGCTACAGTC
AGTCCCCTCGATAATATCG: GTCCCCTCGATAATATCGC
AGTCGAGTAACCAACATCA: GTCGAGTAACCAACATCAG
AGTCGATGATCTAATAGTC: GTCGATGATCTAATAGTCC
AGTCGCTATTAGGGTAGGC: GTCGCTATTAGGGTAGGCA
AGTCTAACGTTCTTCATTG: GTCTAACGTTCTTCATTGT
AGTCTCACAAGTATAAGAT: GTCTCACAAGTATAAGATT
AGTCTCGTTTGGGGTTGCT: GTCTCGTTTGGGGTTGCTG
AGTCTGTGTATTAATCAGT: GTCTGTGTATTAATCAGTT
AGTCTTGGTCGCTTAGGCT: GTCTTGGTCGCTTAGGCTA
AGTGAGCGATGTGCCCCAC: GTGAGCGATGTGCCCCACC
AGTGAGGTGTCCGGTTCGA: GTGAGGTGTCCGGTTCGAA
AGTGCAGCATTATCCTGAA: GTGCAGCATTATCCTGAAC
AGTGTTTCAAAGAATTGCA: GTGTTTCAAAGAATTGCAT
AGTTAGATAGTATCTGGAA: GTTAGATAGTATCTGGAAA
AGTTCAACTTGATGGTCGC: GTTCAACTTGATGGTCGCC
AGTTCGCCGTATACAAGGC: GTTCGCCGTATACAAGGCG
AGTTGAAAGTCGCTATTAG: GTTGAAAGTCGCTATTAGG
AGTTGAGCAACCCGCGCTC: GTTGAGCAACCCGCGCTCA
AGTTGATTAGGAACAGTTA: GTTGATTAGGAACAGTTAG
AGTTGGCCCTATATAGCTC: GTTGGCCCTATATAGCTCG
AGTTTAATTCAGAGCACGA: GTTTAATTCAGAGCACGAA
AGTTTTCCAGCAAGAGTCT: GTTTTCCAGCAAGAGTCTG
ATAAGAATCGGGGAGACTA: TAAGAATCGGGGAGACTAG
ATAAGATTTCGATCAGTCG: TAAGATTTCGATCAGTCGA
ATAAGGAATCTGGGCAACA: TAAGGAATCTGGGCAACAC
ATAAGGGTTATCCGACCAC: TAAGGGTTATCCGACCACG
ATAATATCGCGTCACATTC: TAATATCGCGTCACATTCT
ATAATTATGAGTCAAACCT: TAATTATGAGTCAAACCTA
ATACAAGCTAGCCAATGTG: TACAAGCTAGCCAATGTGT
ATACAAGGCGTGGTTTGCA: TACAAGGCGTGGTTTGCAG
ATACCCAGCACTGGATCAG: TACCCAGCACTGGATCAGT
ATACCCAGCACTGGTCATT: TACCCAGCACTGGTCATTA
ATACCCAGCACTGGTCTGG: TACCCAGCACTGGTCTGGT
ATACCCAGCACTGGTTCCG: TACCCAGCACTGGTTCCGT
ATACGAGAAGGTTGGGAGT: TACGAGAAGGTTGGGAGTC
ATACTCTGTACTGGCATGC: TACTCTGTACTGGCATGCT
ATACTGCGTGCAAGCATTT: TACTGCGTGCAAGCATTTG
ATACTTACATCATAGATGG: TACTTACATCATAGATGGC
ATAGATCGGGAAGATGTAA: TAGATCGGGAAGATGTAAC
ATAGATGGCGTCTGGTTGG: TAGATGGCGTCTGGTTGGT
ATAGCCCGTAACGCTGTAA: TAGCCCGTAACGCTGTAAG
ATAGCTCGCAGTTTAATTC: TAGCTCGCAGTTTAATTCA
ATAGGGGCCGCTTAGTCAT: TAGGGGCCGCTTAGTCATC
ATAGTATCTGGAAATCATC: TAGTATCTGGAAATCATCG
ATAGTCCACTCTAATTCAA: TAGTCCACTCTAATTCAAT
ATAGTCGATGATCTAATAG: TAGTCGATGATCTAATAGT
ATATAGCTCGCAGTTTAAT: TATAGCTCGCAGTTTAATT
ATATCGCGTCACATTCTTG: TATCGCGTCACATTCTTGA
ATATCGTTAGAGTCTAACG: TATCGTTAGAGTCTAACGT
ATATGCGAGTGAGGTGTCC: TATGCGAGTGAGGTGTCCG
ATATTCCCAGTTGATTAGG: TATTCCCAGTTGATTAGGA
ATATTGAAGCGGTAACATG: TATTGAAGCGGTAACATGT
ATCAACATGTCAGAAAAGT: TCAACATGTCAGAAAAGTA
ATCACCGCCTCGGACTCCA: TCACCGCCTCGGACTCCAG
ATCACCGTCTGATAAGGGT: TCACCGTCTGATAAGGGTT
ATCACGCCACGAGTGAGCG: TCACGCCACGAGTGAGCGA
ATCAGAGCGCAGCTAAGAA: TCAGAGCGCAGCTAAGAAG
ATCAGTCGAGTAACCAACA: TCAGTCGAGTAACCAACAT
ATCAGTCTCGTTTGGGGTT: TCAGTCTCGTTTGGGGTTG
ATCAGTTGAAAGTCGCTAT: TCAGTTGAAAGTCGCTATT
ATCATAGATGGCGTCTGGT: TCATAGATGGCGTCTGGTT
ATCATCGGGCGTGTGCTGC: TCATCGGGCGTGTGCTGCA
ATCATTGTCAGATTCCAGC: TCATTGTCAGATTCCAGCG
ATCCGACCACGTGGCGTAG: TCCGACCACGTGGCGTAGC
ATCCGATCGGGATACTGCG: TCCGATCGGGATACTGCGT
ATCCGCCCCGAGACATATT: TCCGCCCCGAGACATATTC
ATCCTGAACCACTTTAGTT: TCCTGAACCACTTTAGTTG
ATCCTGCGGGCTTCCTATC: TCCTGCGGGCTTCCTATCG
ATCCTTCGCTGGATGACCT: TCCTTCGCTGGATGACCTT
ATCGAACAGAGCTCATTCT: TCGAACAGAGCTCATTCTA
ATCGACGAACAGCACCTGG: TCGACGAACAGCACCTGGC
ATCGCATGCGTGTTGAAAG: TCGCATGCGTGTTGAAAGT
ATCGCGTCACATTCTTGAA: TCGCGTCACATTCTTGAAT
ATCGCTGAGGTCCATACGA: TCGCTGAGGTCCATACGAG
ATCGCTGTCCTCTCCGATG: TCGCTGTCCTCTCCGATGT
ATCGCTTGGCTTCAGTCCC: TCGCTTGGCTTCAGTCCCC
ATCGGATCCTTCGCTGGAT: TCGGATCCTTCGCTGGATG
ATCGGGAAGATGTAACTGA: TCGGGAAGATGTAACTGAA
ATCGGGATACTGCGTGCAA: TCGGGATACTGCGTGCAAG
ATCGGGCGTGTGCTGCAGA: TCGGGCGTGTGCTGCAGAG
ATCGGGGAGACTAGGCTTT: TCGGGGAGACTAGGCTTTT
ATCGTCTCGCGTGGGGCGG: TCGTCTCGCGTGGGGCGGG
ATCGTGTATCGTTAGGGTC: TCGTGTATCGTTAGGGTCT
ATCGTTAGAGTCTAACGTT: TCGTTAGAGTCTAACGTTC
ATCGTTAGGGTCTGTGACA: TCGTTAGGGTCTGTGACAG
ATCTAATAGTCCACTCTAA: TCTAATAGTCCACTCTAAT
ATCTACCGTACGGGATGGG: TCTACCGTACGGGATGGGG
ATCTAGAAGTATACTCTGT: TCTAGAAGTATACTCTGTA
ATCTCCTAGTAGCAAACTT: TCTCCTAGTAGCAAACTTT
ATCTCGAAACTTCGATGTG: TCTCGAAACTTCGATGTGC
ATCTCGCTTTGGCTAATTT: TCTCGCTTTGGCTAATTTC
ATCTGACGTAGTCATCAAC: TCTGACGTAGTCATCAACA
ATCTGCCCCAGCTCCACTT: TCTGCCCCAGCTCCACTTG
ATCTGGAAATCATCGGGCG: TCTGGAAATCATCGGGCGT
ATCTGGGCAACACTTGCAG: TCTGGGCAACACTTGCAGA
ATCTTTTCTAGATGTTGGA: TCTTTTCTAGATGTTGGAG
ATGAAACCTATACCCAGCA: TGAAACCTATACCCAGCAC
ATGACCTTGAGGAGCTTAC: TGACCTTGAGGAGCTTACC
ATGACGATGTGCCCCACCT: TGACGATGTGCCCCACCTT
ATGAGTCAAACCTATCGCA: TGAGTCAAACCTATCGCAT
ATGATAAGAATCGGGGAGA: TGATAAGAATCGGGGAGAC
ATGATCGTGTATCGTTAGG: TGATCGTGTATCGTTAGGG
ATGATCTAATAGTCCACTC: TGATCTAATAGTCCACTCT
ATGATGTTCGACCCCAATC: TGATGTTCGACCCCAATCG
ATGCCCTACCCGGTATATC: TGCCCTACCCGGTATATCG
ATGCCTGATCACGCCACGA: TGCCTGATCACGCCACGAG
ATGCGAGTGAGGTGTCCGG: TGCGAGTGAGGTGTCCGGT
ATGCGCTGAAATGTCGGAA: TGCGCTGAAATGTCGGAAA
ATGCGTCATTGATGACGAT: TGCGTCATTGATGACGATG
ATGCGTGTTGAAAGTTGAG: TGCGTGTTGAAAGTTGAGC
ATGCTAACTGAAAGGTACG: TGCTAACTGAAAGGTACGT
ATGGAATCTCGCTTTGGCT: TGGAATCTCGCTTTGGCTA
ATGGCACTTACGCTTCTCG: TGGCACTTACGCTTCTCGA
ATGGCGTCTGGTTGGTATA: TGGCGTCTGGTTGGTATAG
ATGGGACACTTATAGGGGC: TGGGACACTTATAGGGGCC
ATGGGGTTATTTTGCCCCA: TGGGGTTATTTTGCCCCAC
ATGGGTAGAACAGGACCTG: TGGGTAGAACAGGACCTGT
ATGGTCGCCGCGTAAAGCT: TGGTCGCCGCGTAAAGCTA
ATGTAACTGAAGCGTTCAC: TGTAACTGAAGCGTTCACT
ATGTAGACACGGCCATCTC: TGTAGACACGGCCATCTCC
ATGTCAGAAAAGTAAGCCT: TGTCAGAAAAGTAAGCCTG
ATGTCGGAAATCCTGCGGG: TGTCGGAAATCCTGCGGGC
ATGTGCCCCACCTTTGATT: TGTGCCCCACCTTTGATTC
ATGTGCCCCACCTTTGCGC: TGTGCCCCACCTTTGCGCT
ATGTGCCCCACCTTTGGAC: TGTGCCCCACCTTTGGACT
ATGTGCCCCACCTTTGTTC: TGTGCCCCACCTTTGTTCG
ATGTGTTGCGCGCACCGTT: TGTGTTGCGCGCACCGTTC
ATGTTCGACCCCAATCGTC: TGTTCGACCCCAATCGTCT
ATGTTGGAGCGCGAGAGGC: TGTTGGAGCGCGAGAGGCA
ATGTTTCGGCGAATGATAA: TGTTTCGGCGAATGATAAG
ATTAATCAGTTGAAAGTCG: TTAATCAGTTGAAAGTCGC
ATTACATGCGTCATTGATG: TTACATGCGTCATTGATGA
ATTAGGAACAGTTAGATAG: TTAGGAACAGTTAGATAGT
ATTAGGCAGTCTTGGTCGC: TTAGGCAGTCTTGGTCGCT
ATTAGGGTAGGCAACCATT: TTAGGGTAGGCAACCATTT
ATTATCACCGCCTCGGACT: TTATCACCGCCTCGGACTC
ATTATCCTGAACCACTTTA: TTATCCTGAACCACTTTAG
ATTATGAGTCAAACCTATC: TTATGAGTCAAACCTATCG
ATTCAATCGGATCCTTCGC: TTCAATCGGATCCTTCGCT
ATTCAGAGCACGAAAATTG: TTCAGAGCACGAAAATTGC
ATTCCAGCGTTTAGGGCAG: TTCCAGCGTTTAGGGCAGC
ATTCCCAGTTGATTAGGAA: TTCCCAGTTGATTAGGAAC
ATTCGCAATGAAACCTATA: TTCGCAATGAAACCTATAC
ATTCTAACGTAAACAGAAA: TTCTAACGTAAACAGAAAT
ATTCTTGAATGATCGTGTA: TTCTTGAATGATCGTGTAT
ATTGAAGCGGTAACATGTA: TTGAAGCGGTAACATGTAG
ATTGACTCGATTGAGCATA: TTGACTCGATTGAGCATAT
ATTGAGCATATTGAAGCGG: TTGAGCATATTGAAGCGGT
ATTGATGACGATGTGCCCC: TTGATGACGATGTGCCCCA
ATTGCATGCGCTGAAATGT: TTGCATGCGCTGAAATGTC
ATTGCTTCGAGGAGGACCA: TTGCTTCGAGGAGGACCAA
ATTGGTGCACCTGTATCTC: TTGGTGCACCTGTATCTCG
ATTGTCAGATTCCAGCGTT: TTGTCAGATTCCAGCGTTT
ATTGTCCTTGCAGCAATTG: TTGTCCTTGCAGCAATTGT
ATTGTGTTTCTCAGTCAGG: TTGTGTTTCTCAGTCAGGG
ATTTCAGATCATTGTCAGA: TTTCAGATCATTGTCAGAT
ATTTCGATCAGTCGAGTAA: TTTCGATCAGTCGAGTAAC
ATTTCTGACTGGTATCTAG: TTTCTGACTGGTATCTAGA
ATTTGAGAACGTCACTTAA: TTTGAGAACGTCACTTAAA
ATTTGGTGAGGGTGAGTAG: TTTGGTGAGGGTGAGTAGT
ATTTTGCCCCACTTCCATC: TTTTGCCCCACTTCCATCG
ATTTTTACTTCGCAGCCCG: TTTTTACTTCGCAGCCCGC
CAAAATTGACTCGATTGAG: AAAATTGACTCGATTGAGC
CAAACCTATCGCATGCGTG: AAACCTATCGCATGCGTGT
CAAACTTTGTGTCAATCCG: AAACTTTGTGTCAATCCGC
CAAAGAATTGCATGCGCTG: AAAGAATTGCATGCGCTGA
CAAAGTTTTCCAGCAAGAG: AAAGTTTTCCAGCAAGAGT
CAAATACTTACATCATAGA: AAATACTTACATCATAGAT
CAAATTTGAGAACGTCACT: AAATTTGAGAACGTCACTT
CAACACTTGCAGATAATTA: AACACTTGCAGATAATTAT
CAACATCAGAGCGCAGCTA: AACATCAGAGCGCAGCTAA
CAACATGTCAGAAAAGTAA: AACATGTCAGAAAAGTAAG
CAACCATTTTTACTTCGCA: AACCATTTTTACTTCGCAG
CAACCCGCGCTCAGATCTG: AACCCGCGCTCAGATCTGA
CAACGACATTGGTGCACCT: AACGACATTGGTGCACCTG
CAACTAGACCCGATGCCTG: AACTAGACCCGATGCCTGA
CAACTTGATGGTCGCCGCG: AACTTGATGGTCGCCGCGT
CAAGAACCTATACCCAGCA: AAGAACCTATACCCAGCAC
CAAGAGTCTGTGTATTAAT: AAGAGTCTGTGTATTAATC
CAAGCATTTGGTGAGGGTG: AAGCATTTGGTGAGGGTGA
CAAGCTAGCCAATGTGTTG: AAGCTAGCCAATGTGTTGC
CAAGGCGTGGTTTGCAGAA: AAGGCGTGGTTTGCAGAAT
CAAGGGGGCAAAGTTTTCC: AAGGGGGCAAAGTTTTCCA
CAAGTATAAGATTTCGATC: AAGTATAAGATTTCGATCA
CAAGTATGGGACACTTATA: AAGTATGGGACACTTATAG
CAATAGATCGGGAAGATGT: AATAGATCGGGAAGATGTA
CAATATGCGAGTGAGGTGT: AATATGCGAGTGAGGTGTC
CAATCCGCCCCGAGACATA: AATCCGCCCCGAGACATAT
CAATCGGATCCTTCGCTGG: AATCGGATCCTTCGCTGGA
CAATCGTCTCGCGTGGGGC: AATCGTCTCGCGTGGGGCG
CAATGAAACCTATACCCAG: AATGAAACCTATACCCAGC
CAATGCCCTACCCGGTATA: AATGCCCTACCCGGTATAT
CAATGTGTTGCGCGCACCG: AATGTGTTGCGCGCACCGT
CAATGTTTCGGCGAATGAT: AATGTTTCGGCGAATGATA
CAATTATCACCGCCTCGGA: AATTATCACCGCCTCGGAC
CAATTGTGTTTCTCAGTCA: AATTGTGTTTCTCAGTCAG
CACAAGTATAAGATTTCGA: ACAAGTATAAGATTTCGAT
CACAATTATCACCGCCTCG: ACAATTATCACCGCCTCGG
CACAGCGCTACAGTCAGCG: ACAGCGCTACAGTCAGCGC
CACATTCTTGAATGATCGT: ACATTCTTGAATGATCGTG
CACCGACTCTTGTGACCCC: ACCGACTCTTGTGACCCCA
CACCGCCTCGGACTCCAGC: ACCGCCTCGGACTCCAGCG
CACCGTCTGATAAGGGTTA: ACCGTCTGATAAGGGTTAT
CACCGTTCGGATCTGCCCC: ACCGTTCGGATCTGCCCCA
CACCTGGCAAATTTGAGAA: ACCTGGCAAATTTGAGAAC
CACCTGTATCTCGAAACTT: ACCTGTATCTCGAAACTTC
CACCTTTGATTCGCAATGA: ACCTTTGATTCGCAATGAA
CACCTTTGCGCTGCGCAAG: ACCTTTGCGCTGCGCAAGA
CACCTTTGGACTGGGCGTA: ACCTTTGGACTGGGCGTAA
CACCTTTGTTCGGGACTTT: ACCTTTGTTCGGGACTTTA
CACGAAAATTGCTTCGAGG: ACGAAAATTGCTTCGAGGA
CACGAGTGAGCGATGTGCC: ACGAGTGAGCGATGTGCCC
CACGCCACGAGTGAGCGAT: ACGCCACGAGTGAGCGATG
CACGGACCAATGTTTCGGC: ACGGACCAATGTTTCGGCG
CACGGCCATCTCCTAGTAG: ACGGCCATCTCCTAGTAGC
CACGTGGCGTAGCGCCTCC: ACGTGGCGTAGCGCCTCCT
CACGTTTTGTCCAGCGTGA: ACGTTTTGTCCAGCGTGAC
CACTCCCAGTTCAACTTGA: ACTCCCAGTTCAACTTGAT
CACTCTAATTCAATCGGAT: ACTCTAATTCAATCGGATC
CACTGGATCAGTCTCGTTT: ACTGGATCAGTCTCGTTTG
CACTGGTCATTAGGCAGTC: ACTGGTCATTAGGCAGTCT
CACTGGTCTGGTGAAATAC: ACTGGTCTGGTGAAATACA
CACTGGTTCCGTTACGAAA: ACTGGTTCCGTTACGAAAG
CACTTAAACCAGGCTAGGC: ACTTAAACCAGGCTAGGCG
CACTTACGCTTCTCGATCG: ACTTACGCTTCTCGATCGC
CACTTAGAGTGCAGCATTA: ACTTAGAGTGCAGCATTAT
CACTTATAGGGGCCGCTTA: ACTTATAGGGGCCGCTTAG
CACTTCCATCGACGAACAG: ACTTCCATCGACGAACAGC
CACTTGCAGATAATTATGA: ACTTGCAGATAATTATGAG
CACTTGGTGCCGCTTCGTA: ACTTGGTGCCGCTTCGTAG
CACTTTAGTTGGCCCTATA: ACTTTAGTTGGCCCTATAT
CAGAAAAGTAAGCCTGCTC: AGAAAAGTAAGCCTGCTCG
CAGAAATTTCAGATCATTG: AGAAATTTCAGATCATTGT
CAGAATGGCACTTACGCTT: AGAATGGCACTTACGCTTC
CAGAGCACGAAAATTGCTT: AGAGCACGAAAATTGCTTC
CAGAGCGCAGCTAAGAAGA: AGAGCGCAGCTAAGAAGAA
CAGAGCTCATTCTAACGTA: AGAGCTCATTCTAACGTAA
CAGAGTCCCACAGCGCTAC: AGAGTCCCACAGCGCTACA
CAGATAATTATGAGTCAAA: AGATAATTATGAGTCAAAC
CAGATCATTGTCAGATTCC: AGATCATTGTCAGATTCCA
CAGATCTGACGTAGTCATC: AGATCTGACGTAGTCATCA
CAGATTCCAGCGTTTAGGG: AGATTCCAGCGTTTAGGGC
CAGCAAGAGTCTGTGTATT: AGCAAGAGTCTGTGTATTA
CAGCAATTGTGTTTCTCAG: AGCAATTGTGTTTCTCAGT
CAGCACCTGGCAAATTTGA: AGCACCTGGCAAATTTGAG
CAGCACGGACCAATGTTTC: AGCACGGACCAATGTTTCG
CAGCACTGGATCAGTCTCG: AGCACTGGATCAGTCTCGT
CAGCACTGGTCATTAGGCA: AGCACTGGTCATTAGGCAG
CAGCACTGGTCTGGTGAAA: AGCACTGGTCTGGTGAAAT
CAGCACTGGTTCCGTTACG: AGCACTGGTTCCGTTACGA
CAGCATTATCCTGAACCAC: AGCATTATCCTGAACCACT
CAGCCCGCGGATCTACCGT: AGCCCGCGGATCTACCGTA
CAGCGAAGCAATAGATCGG: AGCGAAGCAATAGATCGGG
CAGCGACGGTTTGGTTCTC: AGCGACGGTTTGGTTCTCT
CAGCGCCCCGGATCCGATC: AGCGCCCCGGATCCGATCG
CAGCGCTACAGTCAGCGCC: AGCGCTACAGTCAGCGCCC
CAGCGTGACATGGGTAGAA: AGCGTGACATGGGTAGAAC
CAGCGTTTAGGGCAGCTCA: AGCGTTTAGGGCAGCTCAC
CAGCTAAGAAGAACGTACC: AGCTAAGAAGAACGTACCA
CAGCTCACAATTATCACCG: AGCTCACAATTATCACCGC
CAGCTCCACTTGGTGCCGC: AGCTCCACTTGGTGCCGCT
CAGGACCTGTAGCTAGGGA: AGGACCTGTAGCTAGGGAC
CAGGCTAGGCGTTTGTCCC: AGGCTAGGCGTTTGTCCCT
CAGGGTTCGCTCAACTAGA: AGGGTTCGCTCAACTAGAC
CAGTATAGTCGATGATCTA: AGTATAGTCGATGATCTAA
CAGTCAGCGCCCCGGATCC: AGTCAGCGCCCCGGATCCG
CAGTCAGGGTTCGCTCAAC: AGTCAGGGTTCGCTCAACT
CAGTCCCCTCGATAATATC: AGTCCCCTCGATAATATCG
CAGTCGAGTAACCAACATC: AGTCGAGTAACCAACATCA
CAGTCTCGTTTGGGGTTGC: AGTCTCGTTTGGGGTTGCT
CAGTCTTGGTCGCTTAGGC: AGTCTTGGTCGCTTAGGCT
CAGTTAGATAGTATCTGGA: AGTTAGATAGTATCTGGAA
CAGTTCAACTTGATGGTCG: AGTTCAACTTGATGGTCGC
CAGTTGAAAGTCGCTATTA: AGTTGAAAGTCGCTATTAG
CAGTTGATTAGGAACAGTT: AGTTGATTAGGAACAGTTA
CAGTTTAATTCAGAGCACG: AGTTTAATTCAGAGCACGA
CATAAGGAATCTGGGCAAC: ATAAGGAATCTGGGCAACA
CATACGAGAAGGTTGGGAG: ATACGAGAAGGTTGGGAGT
CATAGATGGCGTCTGGTTG: ATAGATGGCGTCTGGTTGG
CATATTCCCAGTTGATTAG: ATATTCCCAGTTGATTAGG
CATATTGAAGCGGTAACAT: ATATTGAAGCGGTAACATG
CATCAACATGTCAGAAAAG: ATCAACATGTCAGAAAAGT
CATCAGAGCGCAGCTAAGA: ATCAGAGCGCAGCTAAGAA
CATCATAGATGGCGTCTGG: ATCATAGATGGCGTCTGGT
CATCGACGAACAGCACCTG: ATCGACGAACAGCACCTGG
CATCGCTGAGGTCCATACG: ATCGCTGAGGTCCATACGA
CATCGGGCGTGTGCTGCAG: ATCGGGCGTGTGCTGCAGA
CATCTCCTAGTAGCAAACT: ATCTCCTAGTAGCAAACTT
CATGATGTTCGACCCCAAT: ATGATGTTCGACCCCAATC
CATGCGCTGAAATGTCGGA: ATGCGCTGAAATGTCGGAA
CATGCGTCATTGATGACGA: ATGCGTCATTGATGACGAT
CATGCGTGTTGAAAGTTGA: ATGCGTGTTGAAAGTTGAG
CATGCTAACTGAAAGGTAC: ATGCTAACTGAAAGGTACG
CATGGGTAGAACAGGACCT: ATGGGTAGAACAGGACCTG
CATGTAGACACGGCCATCT: ATGTAGACACGGCCATCTC
CATGTCAGAAAAGTAAGCC: ATGTCAGAAAAGTAAGCCT
CATTAGGCAGTCTTGGTCG: ATTAGGCAGTCTTGGTCGC
CATTATCCTGAACCACTTT: ATTATCCTGAACCACTTTA
CATTCTAACGTAAACAGAA: ATTCTAACGTAAACAGAAA
CATTCTTGAATGATCGTGT: ATTCTTGAATGATCGTGTA
CATTGATGACGATGTGCCC: ATTGATGACGATGTGCCCC
CATTGGTGCACCTGTATCT: ATTGGTGCACCTGTATCTC
CATTGTCAGATTCCAGCGT: ATTGTCAGATTCCAGCGTT
CATTGTCCTTGCAGCAATT: ATTGTCCTTGCAGCAATTG
CATTTGGTGAGGGTGAGTA: ATTTGGTGAGGGTGAGTAG
CATTTTTACTTCGCAGCCC: ATTTTTACTTCGCAGCCCG
CCAACATCAGAGCGCAGCT: CAACATCAGAGCGCAGCTA
CCAAGGGGGCAAAGTTTTC: CAAGGGGGCAAAGTTTTCC
CCAATATGCGAGTGAGGTG: CAATATGCGAGTGAGGTGT
CCAATCGTCTCGCGTGGGG: CAATCGTCTCGCGTGGGGC
CCAATGCCCTACCCGGTAT: CAATGCCCTACCCGGTATA
CCAATGTGTTGCGCGCACC: CAATGTGTTGCGCGCACCG
CCAATGTTTCGGCGAATGA: CAATGTTTCGGCGAATGAT
CCACAGCGCTACAGTCAGC: CACAGCGCTACAGTCAGCG
CCACCTTTGATTCGCAATG: CACCTTTGATTCGCAATGA
CCACCTTTGCGCTGCGCAA: CACCTTTGCGCTGCGCAAG
CCACCTTTGGACTGGGCGT: CACCTTTGGACTGGGCGTA
CCACCTTTGTTCGGGACTT: CACCTTTGTTCGGGACTTT
CCACGAGTGAGCGATGTGC: CACGAGTGAGCGATGTGCC
CCACGTGGCGTAGCGCCTC: CACGTGGCGTAGCGCCTCC
CCACTCCCAGTTCAACTTG: CACTCCCAGTTCAACTTGA
CCACTCTAATTCAATCGGA: CACTCTAATTCAATCGGAT
CCACTTCCATCGACGAACA: CACTTCCATCGACGAACAG
CCACTTGGTGCCGCTTCGT: CACTTGGTGCCGCTTCGTA
CCACTTTAGTTGGCCCTAT: CACTTTAGTTGGCCCTATA
CCAGCAAGAGTCTGTGTAT: CAGCAAGAGTCTGTGTATT
CCAGCACTGGATCAGTCTC: CAGCACTGGATCAGTCTCG
CCAGCACTGGTCATTAGGC: CAGCACTGGTCATTAGGCA
CCAGCACTGGTCTGGTGAA: CAGCACTGGTCTGGTGAAA
CCAGCACTGGTTCCGTTAC: CAGCACTGGTTCCGTTACG
CCAGCGACGGTTTGGTTCT: CAGCGACGGTTTGGTTCTC
CCAGCGTGACATGGGTAGA: CAGCGTGACATGGGTAGAA
CCAGCGTTTAGGGCAGCTC: CAGCGTTTAGGGCAGCTCA
CCAGCTCCACTTGGTGCCG: CAGCTCCACTTGGTGCCGC
CCAGGCTAGGCGTTTGTCC: CAGGCTAGGCGTTTGTCCC
CCAGTTCAACTTGATGGTC: CAGTTCAACTTGATGGTCG
CCAGTTGATTAGGAACAGT: CAGTTGATTAGGAACAGTT
CCATAAGGAATCTGGGCAA: CATAAGGAATCTGGGCAAC
CCATACGAGAAGGTTGGGA: CATACGAGAAGGTTGGGAG
CCATCGACGAACAGCACCT: CATCGACGAACAGCACCTG
CCATCTCCTAGTAGCAAAC: CATCTCCTAGTAGCAAACT
CCATGATGTTCGACCCCAA: CATGATGTTCGACCCCAAT
CCATTTTTACTTCGCAGCC: CATTTTTACTTCGCAGCCC
CCCAATATGCGAGTGAGGT: CCAATATGCGAGTGAGGTG
CCCAATCGTCTCGCGTGGG: CCAATCGTCTCGCGTGGGG
CCCACAGCGCTACAGTCAG: CCACAGCGCTACAGTCAGC
CCCACCTTTGATTCGCAAT: CCACCTTTGATTCGCAATG
CCCACCTTTGCGCTGCGCA: CCACCTTTGCGCTGCGCAA
CCCACCTTTGGACTGGGCG: CCACCTTTGGACTGGGCGT
CCCACCTTTGTTCGGGACT: CCACCTTTGTTCGGGACTT
CCCACTTCCATCGACGAAC: CCACTTCCATCGACGAACA
CCCAGCACTGGATCAGTCT: CCAGCACTGGATCAGTCTC
CCCAGCACTGGTCATTAGG: CCAGCACTGGTCATTAGGC
CCCAGCACTGGTCTGGTGA: CCAGCACTGGTCTGGTGAA
CCCAGCACTGGTTCCGTTA: CCAGCACTGGTTCCGTTAC
CCCAGCTCCACTTGGTGCC: CCAGCTCCACTTGGTGCCG
CCCAGTTCAACTTGATGGT: CCAGTTCAACTTGATGGTC
CCCAGTTGATTAGGAACAG: CCAGTTGATTAGGAACAGT
CCCATAAGGAATCTGGGCA: CCATAAGGAATCTGGGCAA
CCCCAATCGTCTCGCGTGG: CCCAATCGTCTCGCGTGGG
CCCCACCTTTGATTCGCAA: CCCACCTTTGATTCGCAAT
CCCCACCTTTGCGCTGCGC: CCCACCTTTGCGCTGCGCA
CCCCACCTTTGGACTGGGC: CCCACCTTTGGACTGGGCG
CCCCACCTTTGTTCGGGAC: CCCACCTTTGTTCGGGACT
CCCCACTTCCATCGACGAA: CCCACTTCCATCGACGAAC
CCCCAGCTCCACTTGGTGC: CCCAGCTCCACTTGGTGCC
CCCCATAAGGAATCTGGGC: CCCATAAGGAATCTGGGCA
CCCCGAGACATATTCCCAG: CCCGAGACATATTCCCAGT
CCCCGGATCCGATCGGGAT: CCCGGATCCGATCGGGATA
CCCCTCGATAATATCGCGT: CCCTCGATAATATCGCGTC
CCCGAGACATATTCCCAGT: CCGAGACATATTCCCAGTT
CCCGATGCCTGATCACGCC: CCGATGCCTGATCACGCCA
CCCGCGCTCAGATCTGACG: CCGCGCTCAGATCTGACGT
CCCGCGGATCTACCGTACG: CCGCGGATCTACCGTACGG
CCCGGATCCGATCGGGATA: CCGGATCCGATCGGGATAC
CCCGGGTTCCACTCCCAGT: CCGGGTTCCACTCCCAGTT
CCCGGTATATCGTTAGAGT: CCGGTATATCGTTAGAGTC
CCCGTAACGCTGTAAGACA: CCGTAACGCTGTAAGACAG
CCCTACCCGGTATATCGTT: CCTACCCGGTATATCGTTA
CCCTATATAGCTCGCAGTT: CCTATATAGCTCGCAGTTT
CCCTATGGAATCTCGCTTT: CCTATGGAATCTCGCTTTG
CCCTCGATAATATCGCGTC: CCTCGATAATATCGCGTCA
CCGACCACGTGGCGTAGCG: CGACCACGTGGCGTAGCGC
CCGACTCTTGTGACCCCAT: CGACTCTTGTGACCCCATA
CCGAGACATATTCCCAGTT: CGAGACATATTCCCAGTTG
CCGATCGGGATACTGCGTG: CGATCGGGATACTGCGTGC
CCGATGCCTGATCACGCCA: CGATGCCTGATCACGCCAC
CCGATGTGCCCCACCTTTG: CGATGTGCCCCACCTTTGC
CCGCCCCGAGACATATTCC: CGCCCCGAGACATATTCCC
CCGCCTCGGACTCCAGCGA: CGCCTCGGACTCCAGCGAC
CCGCGCTCAGATCTGACGT: CGCGCTCAGATCTGACGTA
CCGCGGATCTACCGTACGG: CGCGGATCTACCGTACGGG
CCGCGTAAAGCTAGTTCGC: CGCGTAAAGCTAGTTCGCC
CCGCTTAGTCATCGCTGAG: CGCTTAGTCATCGCTGAGG
CCGCTTCGTAGCTTTGAGA: CGCTTCGTAGCTTTGAGAT
CCGGATCCGATCGGGATAC: CGGATCCGATCGGGATACT
CCGGGTTCCACTCCCAGTT: CGGGTTCCACTCCCAGTTC
CCGGTATATCGTTAGAGTC: CGGTATATCGTTAGAGTCT
CCGGTTCGAACAGTATAGT: CGGTTCGAACAGTATAGTC
CCGTAACGCTGTAAGACAG: CGTAACGCTGTAAGACAGC
CCGTACGGGATGGGGTTAT: CGTACGGGATGGGGTTATT
CCGTATACAAGGCGTGGTT: CGTATACAAGGCGTGGTTT
CCGTCTGATAAGGGTTATC: CGTCTGATAAGGGTTATCC
CCGTTACGAAAGCTGCGTA: CGTTACGAAAGCTGCGTAG
CCGTTCGGATCTGCCCCAG: CGTTCGGATCTGCCCCAGC
CCTACCCGGTATATCGTTA: CTACCCGGTATATCGTTAG
CCTAGTAGCAAACTTTGTG: CTAGTAGCAAACTTTGTGT
CCTATACCCAGCACTGGAT: CTATACCCAGCACTGGATC
CCTATACCCAGCACTGGTC: CTATACCCAGCACTGGTCA CTATACCCAGCACTGGTCT
CCTATACCCAGCACTGGTT: CTATACCCAGCACTGGTTC
CCTATATAGCTCGCAGTTT: CTATATAGCTCGCAGTTTA
CCTATCGAACAGAGCTCAT: CTATCGAACAGAGCTCATT
CCTATCGCATGCGTGTTGA: CTATCGCATGCGTGTTGAA
CCTATCTTTTCTAGATGTT: CTATCTTTTCTAGATGTTG
CCTATGGAATCTCGCTTTG: CTATGGAATCTCGCTTTGG
CCTCCTATCTTTTCTAGAT: CTCCTATCTTTTCTAGATG
CCTCGATAATATCGCGTCA: CTCGATAATATCGCGTCAC
CCTCGGACTCCAGCGACGG: CTCGGACTCCAGCGACGGT
CCTCTCCGATGTGCCCCAC: CTCTCCGATGTGCCCCACC
CCTGAACCACTTTAGTTGG: CTGAACCACTTTAGTTGGC
CCTGATCACGCCACGAGTG: CTGATCACGCCACGAGTGA
CCTGCGGGCTTCCTATCGA: CTGCGGGCTTCCTATCGAA
CCTGCTCGCACGTTTTGTC: CTGCTCGCACGTTTTGTCC
CCTGGCAAATTTGAGAACG: CTGGCAAATTTGAGAACGT
CCTGTAGCTAGGGACGACG: CTGTAGCTAGGGACGACGA
CCTGTATCTCGAAACTTCG: CTGTATCTCGAAACTTCGA
CCTTATTACATGCGTCATT: CTTATTACATGCGTCATTG
CCTTCGCTGGATGACCTTG: CTTCGCTGGATGACCTTGA
CCTTGAGGAGCTTACCATG: CTTGAGGAGCTTACCATGA
CCTTGCAGCAATTGTGTTT: CTTGCAGCAATTGTGTTTC
CCTTTGATTCGCAATGAAA: CTTTGATTCGCAATGAAAC
CCTTTGCGCTGCGCAAGAA: CTTTGCGCTGCGCAAGAAC
CCTTTGGACTGGGCGTAAA: CTTTGGACTGGGCGTAAAC
CCTTTGTTCGGGACTTTAA: CTTTGTTCGGGACTTTAAC
CGAAAATTGCTTCGAGGAG: GAAAATTGCTTCGAGGAGG
CGAAACTTCGATGTGCCCC: GAAACTTCGATGTGCCCCA
CGAAAGCTGCGTAGACAAA: GAAAGCTGCGTAGACAAAT
CGAACAGAGCTCATTCTAA: GAACAGAGCTCATTCTAAC
CGAACAGCACCTGGCAAAT: GAACAGCACCTGGCAAATT
CGAACAGTATAGTCGATGA: GAACAGTATAGTCGATGAT
CGAAGCAATAGATCGGGAA: GAAGCAATAGATCGGGAAG
CGAATGATAAGAATCGGGG: GAATGATAAGAATCGGGGA
CGACATTGGTGCACCTGTA: GACATTGGTGCACCTGTAT
CGACCACGTGGCGTAGCGC: GACCACGTGGCGTAGCGCC
CGACCCCAATCGTCTCGCG: GACCCCAATCGTCTCGCGT
CGACGAACAGCACCTGGCA: GACGAACAGCACCTGGCAA
CGACGGTTTGGTTCTCTCA: GACGGTTTGGTTCTCTCAC
CGACTCTTGTGACCCCATA: GACTCTTGTGACCCCATAA
CGAGAAGGTTGGGAGTCTC: GAGAAGGTTGGGAGTCTCA
CGAGACATATTCCCAGTTG: GAGACATATTCCCAGTTGA
CGAGAGGCAACGACATTGG: GAGAGGCAACGACATTGGT
CGAGGAGGACCAAGGGGGC: GAGGAGGACCAAGGGGGCA
CGAGTAACCAACATCAGAG: GAGTAACCAACATCAGAGC
CGAGTGAGCGATGTGCCCC: GAGTGAGCGATGTGCCCCA
CGAGTGAGGTGTCCGGTTC: GAGTGAGGTGTCCGGTTCG
CGATAATATCGCGTCACAT: GATAATATCGCGTCACATT
CGATCAGTCGAGTAACCAA: GATCAGTCGAGTAACCAAC
CGATCGCTGTCCTCTCCGA: GATCGCTGTCCTCTCCGAT
CGATCGGGATACTGCGTGC: GATCGGGATACTGCGTGCA
CGATGATCTAATAGTCCAC: GATGATCTAATAGTCCACT
CGATGCCTGATCACGCCAC: GATGCCTGATCACGCCACG
CGATGTGCCCCACCTTTGA: GATGTGCCCCACCTTTGAT
CGATGTGCCCCACCTTTGC: GATGTGCCCCACCTTTGCG
CGATGTGCCCCACCTTTGG: GATGTGCCCCACCTTTGGA
CGATGTGCCCCACCTTTGT: GATGTGCCCCACCTTTGTT
CGATTGAGCATATTGAAGC: GATTGAGCATATTGAAGCG
CGCAAGAACCTATACCCAG: GCAAGAACCTATACCCAGC
CGCAATGAAACCTATACCC: GCAATGAAACCTATACCCA
CGCACCGTTCGGATCTGCC: GCACCGTTCGGATCTGCCC
CGCACGTTTTGTCCAGCGT: GCACGTTTTGTCCAGCGTG
CGCAGCCCGCGGATCTACC: GCAGCCCGCGGATCTACCG
CGCAGCTAAGAAGAACGTA: GCAGCTAAGAAGAACGTAC
CGCAGTTTAATTCAGAGCA: GCAGTTTAATTCAGAGCAC
CGCATGCGTGTTGAAAGTT: GCATGCGTGTTGAAAGTTG
CGCCACGAGTGAGCGATGT: GCCACGAGTGAGCGATGTG
CGCCCCGAGACATATTCCC: GCCCCGAGACATATTCCCA
CGCCCCGGATCCGATCGGG: GCCCCGGATCCGATCGGGA
CGCCGCGTAAAGCTAGTTC: GCCGCGTAAAGCTAGTTCG
CGCCGTATACAAGGCGTGG: GCCGTATACAAGGCGTGGT
CGCCTCCTATCTTTTCTAG: GCCTCCTATCTTTTCTAGA
CGCCTCGGACTCCAGCGAC: GCCTCGGACTCCAGCGACG
CGCGAGAGGCAACGACATT: GCGAGAGGCAACGACATTG
CGCGCACCGTTCGGATCTG: GCGCACCGTTCGGATCTGC
CGCGCTCAGATCTGACGTA: GCGCTCAGATCTGACGTAG
CGCGGATCTACCGTACGGG: GCGGATCTACCGTACGGGA
CGCGTAAAGCTAGTTCGCC: GCGTAAAGCTAGTTCGCCG
CGCGTCACATTCTTGAATG: GCGTCACATTCTTGAATGA
CGCGTGGGGCGGGTCGGGC: GCGTGGGGCGGGTCGGGCC
CGCTACAGTCAGCGCCCCG: GCTACAGTCAGCGCCCCGG
CGCTATTAGGGTAGGCAAC: GCTATTAGGGTAGGCAACC
CGCTCAACTAGACCCGATG: GCTCAACTAGACCCGATGC
CGCTCAGATCTGACGTAGT: GCTCAGATCTGACGTAGTC
CGCTGAAATGTCGGAAATC: GCTGAAATGTCGGAAATCC
CGCTGAGGTCCATACGAGA: GCTGAGGTCCATACGAGAA
CGCTGCGCAAGAACCTATA: GCTGCGCAAGAACCTATAC
CGCTGGATGACCTTGAGGA: GCTGGATGACCTTGAGGAG
CGCTGTAAGACAGCACGGA: GCTGTAAGACAGCACGGAC
CGCTGTCCTCTCCGATGTG: GCTGTCCTCTCCGATGTGC
CGCTTAGGCTAAGAAAAAG: GCTTAGGCTAAGAAAAAGC
CGCTTAGTCATCGCTGAGG: GCTTAGTCATCGCTGAGGT
CGCTTCGTAGCTTTGAGAT: GCTTCGTAGCTTTGAGATC
CGCTTCTCGATCGCTGTCC: GCTTCTCGATCGCTGTCCT
CGCTTGGCTTCAGTCCCCT: GCTTGGCTTCAGTCCCCTC
CGCTTTGGCTAATTTCTGA: GCTTTGGCTAATTTCTGAC
CGGAAATCCTGCGGGCTTC: GGAAATCCTGCGGGCTTCC
CGGACCAATGTTTCGGCGA: GGACCAATGTTTCGGCGAA
CGGACTCCAGCGACGGTTT: GGACTCCAGCGACGGTTTG
CGGATCCGATCGGGATACT: GGATCCGATCGGGATACTG
CGGATCCTTCGCTGGATGA: GGATCCTTCGCTGGATGAC
CGGATCTACCGTACGGGAT: GGATCTACCGTACGGGATG
CGGATCTGCCCCAGCTCCA: GGATCTGCCCCAGCTCCAC
CGGCCATCTCCTAGTAGCA: GGCCATCTCCTAGTAGCAA
CGGCGAATGATAAGAATCG: GGCGAATGATAAGAATCGG
CGGGAAGATGTAACTGAAG: GGGAAGATGTAACTGAAGC
CGGGACTTTAACCTATACC: GGGACTTTAACCTATACCC
CGGGATACTGCGTGCAAGC: GGGATACTGCGTGCAAGCA
CGGGATGGGGTTATTTTGC: GGGATGGGGTTATTTTGCC
CGGGCCCGGGTTCCACTCC: GGGCCCGGGTTCCACTCCC
CGGGCGTGTGCTGCAGAGT: GGGCGTGTGCTGCAGAGTC
CGGGCTTCCTATCGAACAG: GGGCTTCCTATCGAACAGA
CGGGGAGACTAGGCTTTTG: GGGGAGACTAGGCTTTTGA
CGGGTCGGGCCCGGGTTCC: GGGTCGGGCCCGGGTTCCA
CGGGTTCCACTCCCAGTTC: GGGTTCCACTCCCAGTTCA
CGGTAACATGTAGACACGG: GGTAACATGTAGACACGGC
CGGTATATCGTTAGAGTCT: GGTATATCGTTAGAGTCTA
CGGTTCGAACAGTATAGTC: GGTTCGAACAGTATAGTCG
CGGTTTGGTTCTCTCACCG: GGTTTGGTTCTCTCACCGA
CGTAAACAGAAATTTCAGA: GTAAACAGAAATTTCAGAT
CGTAAACCTATACCCAGCA: GTAAACCTATACCCAGCAC
CGTAAAGCTAGTTCGCCGT: GTAAAGCTAGTTCGCCGTA
CGTAACGCTGTAAGACAGC: GTAACGCTGTAAGACAGCA
CGTACCAATGCCCTACCCG: GTACCAATGCCCTACCCGG
CGTACGGGATGGGGTTATT: GTACGGGATGGGGTTATTT
CGTAGACAAATACTTACAT: GTAGACAAATACTTACATC
CGTAGCGCCTCCTATCTTT: GTAGCGCCTCCTATCTTTT
CGTAGCTTTGAGATCGCTT: GTAGCTTTGAGATCGCTTG
CGTAGTCATCAACATGTCA: GTAGTCATCAACATGTCAG
CGTATACAAGGCGTGGTTT: GTATACAAGGCGTGGTTTG
CGTCACATTCTTGAATGAT: GTCACATTCTTGAATGATC
CGTCACTTAAACCAGGCTA: GTCACTTAAACCAGGCTAG
CGTCATTGATGACGATGTG: GTCATTGATGACGATGTGC
CGTCTCGCGTGGGGCGGGT: GTCTCGCGTGGGGCGGGTC
CGTCTGATAAGGGTTATCC: GTCTGATAAGGGTTATCCG
CGTCTGGTTGGTATAGCCC: GTCTGGTTGGTATAGCCCG
CGTGACATGGGTAGAACAG: GTGACATGGGTAGAACAGG
CGTGCAAGCATTTGGTGAG: GTGCAAGCATTTGGTGAGG
CGTGGCGTAGCGCCTCCTA: GTGGCGTAGCGCCTCCTAT
CGTGGGGCGGGTCGGGCCC: GTGGGGCGGGTCGGGCCCG
CGTGGTTTGCAGAATGGCA: GTGGTTTGCAGAATGGCAC
CGTGTATCGTTAGGGTCTG: GTGTATCGTTAGGGTCTGT
CGTGTGCTGCAGAGTCCCA: GTGTGCTGCAGAGTCCCAC
CGTGTTGAAAGTTGAGCAA: GTGTTGAAAGTTGAGCAAC
CGTTACGAAAGCTGCGTAG: GTTACGAAAGCTGCGTAGA
CGTTAGAGTCTAACGTTCT: GTTAGAGTCTAACGTTCTT
CGTTAGGGTCTGTGACAGC: GTTAGGGTCTGTGACAGCG
CGTTCAAGTATGGGACACT: GTTCAAGTATGGGACACTT
CGTTCACTTAGAGTGCAGC: GTTCACTTAGAGTGCAGCA
CGTTCGGATCTGCCCCAGC: GTTCGGATCTGCCCCAGCT
CGTTCTTCATTGTCCTTGC: GTTCTTCATTGTCCTTGCA
CGTTTAGGGCAGCTCACAA: GTTTAGGGCAGCTCACAAT
CGTTTGGGGTTGCTGACCT: GTTTGGGGTTGCTGACCTT
CGTTTGTCCCTATGGAATC: GTTTGTCCCTATGGAATCT
CGTTTTGTCCAGCGTGACA: GTTTTGTCCAGCGTGACAT
CTAACGTAAACAGAAATTT: TAACGTAAACAGAAATTTC
CTAACGTTCTTCATTGTCC: TAACGTTCTTCATTGTCCT
CTAACTGAAAGGTACGTTC: TAACTGAAAGGTACGTTCA
CTAAGAAAAAGCCCAATAT: TAAGAAAAAGCCCAATATG
CTAAGAAGAACGTACCAAT: TAAGAAGAACGTACCAATG
CTAATAGTCCACTCTAATT: TAATAGTCCACTCTAATTC
CTAATTCAATCGGATCCTT: TAATTCAATCGGATCCTTC
CTAATTTCTGACTGGTATC: TAATTTCTGACTGGTATCT
CTACAGTCAGCGCCCCGGA: TACAGTCAGCGCCCCGGAT
CTACCCGGTATATCGTTAG: TACCCGGTATATCGTTAGA
CTACCGTACGGGATGGGGT: TACCGTACGGGATGGGGTT
CTAGAAGTATACTCTGTAC: TAGAAGTATACTCTGTACT
CTAGACCCGATGCCTGATC: TAGACCCGATGCCTGATCA
CTAGATGTTGGAGCGCGAG: TAGATGTTGGAGCGCGAGA
CTAGCCAATGTGTTGCGCG: TAGCCAATGTGTTGCGCGC
CTAGGCGTTTGTCCCTATG: TAGGCGTTTGTCCCTATGG
CTAGGCTTTTGAAGCAAAA: TAGGCTTTTGAAGCAAAAT
CTAGGGACGACGATGGTAT: TAGGGACGACGATGGTATT
CTAGTAGCAAACTTTGTGT: TAGTAGCAAACTTTGTGTC
CTAGTTCGCCGTATACAAG: TAGTTCGCCGTATACAAGG
CTATACCCAGCACTGGATC: TATACCCAGCACTGGATCA
CTATACCCAGCACTGGTCA: TATACCCAGCACTGGTCAT
CTATACCCAGCACTGGTCT: TATACCCAGCACTGGTCTG
CTATACCCAGCACTGGTTC: TATACCCAGCACTGGTTCC
CTATATAGCTCGCAGTTTA: TATATAGCTCGCAGTTTAA
CTATCGAACAGAGCTCATT: TATCGAACAGAGCTCATTC
CTATCGCATGCGTGTTGAA: TATCGCATGCGTGTTGAAA
CTATCTTTTCTAGATGTTG: TATCTTTTCTAGATGTTGG
CTATGGAATCTCGCTTTGG: TATGGAATCTCGCTTTGGC
CTATTAGGGTAGGCAACCA: TATTAGGGTAGGCAACCAT
CTCAACTAGACCCGATGCC: TCAACTAGACCCGATGCCT
CTCACAAGTATAAGATTTC: TCACAAGTATAAGATTTCG
CTCACAATTATCACCGCCT: TCACAATTATCACCGCCTC
CTCACCGACTCTTGTGACC: TCACCGACTCTTGTGACCC
CTCAGATCTGACGTAGTCA: TCAGATCTGACGTAGTCAT
CTCAGTCAGGGTTCGCTCA: TCAGTCAGGGTTCGCTCAA
CTCATTCTAACGTAAACAG: TCATTCTAACGTAAACAGA
CTCCACTTGGTGCCGCTTC: TCCACTTGGTGCCGCTTCG
CTCCAGCGACGGTTTGGTT: TCCAGCGACGGTTTGGTTC
CTCCCAGTTCAACTTGATG: TCCCAGTTCAACTTGATGG
CTCCGATGTGCCCCACCTT: TCCGATGTGCCCCACCTTT
CTCCTAGTAGCAAACTTTG: TCCTAGTAGCAAACTTTGT
CTCCTATCTTTTCTAGATG: TCCTATCTTTTCTAGATGT
CTCGAAACTTCGATGTGCC: TCGAAACTTCGATGTGCCC
CTCGATAATATCGCGTCAC: TCGATAATATCGCGTCACA
CTCGATCGCTGTCCTCTCC: TCGATCGCTGTCCTCTCCG
CTCGATTGAGCATATTGAA: TCGATTGAGCATATTGAAG
CTCGCACGTTTTGTCCAGC: TCGCACGTTTTGTCCAGCG
CTCGCAGTTTAATTCAGAG: TCGCAGTTTAATTCAGAGC
CTCGCGTGGGGCGGGTCGG: TCGCGTGGGGCGGGTCGGG
CTCGCTTTGGCTAATTTCT: TCGCTTTGGCTAATTTCTG
CTCGGACTCCAGCGACGGT: TCGGACTCCAGCGACGGTT
CTCGTTTGGGGTTGCTGAC: TCGTTTGGGGTTGCTGACC
CTCTAATTCAATCGGATCC: TCTAATTCAATCGGATCCT
CTCTCACCGACTCTTGTGA: TCTCACCGACTCTTGTGAC
CTCTCCGATGTGCCCCACC: TCTCCGATGTGCCCCACCT
CTCTGTACTGGCATGCTAA: TCTGTACTGGCATGCTAAC
CTCTTGTGACCCCATAAGG: TCTTGTGACCCCATAAGGA
CTGAAAGGTACGTTCAAGT: TGAAAGGTACGTTCAAGTA
CTGAAATGTCGGAAATCCT: TGAAATGTCGGAAATCCTG
CTGAACCACTTTAGTTGGC: TGAACCACTTTAGTTGGCC
CTGAAGCGTTCACTTAGAG: TGAAGCGTTCACTTAGAGT
CTGACCTTATTACATGCGT: TGACCTTATTACATGCGTC
CTGACGTAGTCATCAACAT: TGACGTAGTCATCAACATG
CTGACTGGTATCTAGAAGT: TGACTGGTATCTAGAAGTA
CTGAGGTCCATACGAGAAG: TGAGGTCCATACGAGAAGG
CTGATAAGGGTTATCCGAC: TGATAAGGGTTATCCGACC
CTGATCACGCCACGAGTGA: TGATCACGCCACGAGTGAG
CTGCAGAGTCCCACAGCGC: TGCAGAGTCCCACAGCGCT
CTGCCCCAGCTCCACTTGG: TGCCCCAGCTCCACTTGGT
CTGCGCAAGAACCTATACC: TGCGCAAGAACCTATACCC
CTGCGGGCTTCCTATCGAA: TGCGGGCTTCCTATCGAAC
CTGCGTAGACAAATACTTA: TGCGTAGACAAATACTTAC
CTGCGTGCAAGCATTTGGT: TGCGTGCAAGCATTTGGTG
CTGCTCGCACGTTTTGTCC: TGCTCGCACGTTTTGTCCA
CTGGAAATCATCGGGCGTG: TGGAAATCATCGGGCGTGT
CTGGATCAGTCTCGTTTGG: TGGATCAGTCTCGTTTGGG
CTGGATGACCTTGAGGAGC: TGGATGACCTTGAGGAGCT
CTGGCAAATTTGAGAACGT: TGGCAAATTTGAGAACGTC
CTGGCATGCTAACTGAAAG: TGGCATGCTAACTGAAAGG
CTGGGCAACACTTGCAGAT: TGGGCAACACTTGCAGATA
CTGGGCGTAAACCTATACC: TGGGCGTAAACCTATACCC
CTGGTATCTAGAAGTATAC: TGGTATCTAGAAGTATACT
CTGGTCATTAGGCAGTCTT: TGGTCATTAGGCAGTCTTG
CTGGTCTGGTGAAATACAA: TGGTCTGGTGAAATACAAG
CTGGTGAAATACAAGCTAG: TGGTGAAATACAAGCTAGC
CTGGTTCCGTTACGAAAGC: TGGTTCCGTTACGAAAGCT
CTGGTTGGTATAGCCCGTA: TGGTTGGTATAGCCCGTAA
CTGTAAGACAGCACGGACC: TGTAAGACAGCACGGACCA
CTGTACTGGCATGCTAACT: TGTACTGGCATGCTAACTG
CTGTAGCTAGGGACGACGA: TGTAGCTAGGGACGACGAT
CTGTATCTCGAAACTTCGA: TGTATCTCGAAACTTCGAT
CTGTCCTCTCCGATGTGCC: TGTCCTCTCCGATGTGCCC
CTGTGACAGCGAAGCAATA: TGTGACAGCGAAGCAATAG
CTGTGTATTAATCAGTTGA: TGTGTATTAATCAGTTGAA
CTTAAACCAGGCTAGGCGT: TTAAACCAGGCTAGGCGTT
CTTACATCATAGATGGCGT: TTACATCATAGATGGCGTC
CTTACCATGATGTTCGACC: TTACCATGATGTTCGACCC
CTTACGCTTCTCGATCGCT: TTACGCTTCTCGATCGCTG
CTTAGAGTGCAGCATTATC: TTAGAGTGCAGCATTATCC
CTTAGGCTAAGAAAAAGCC: TTAGGCTAAGAAAAAGCCC
CTTAGTCATCGCTGAGGTC: TTAGTCATCGCTGAGGTCC
CTTATAGGGGCCGCTTAGT: TTATAGGGGCCGCTTAGTC
CTTATTACATGCGTCATTG: TTATTACATGCGTCATTGA
CTTCAGTCCCCTCGATAAT: TTCAGTCCCCTCGATAATA
CTTCATTGTCCTTGCAGCA: TTCATTGTCCTTGCAGCAA
CTTCCATCGACGAACAGCA: TTCCATCGACGAACAGCAC
CTTCCTATCGAACAGAGCT: TTCCTATCGAACAGAGCTC
CTTCGAGGAGGACCAAGGG: TTCGAGGAGGACCAAGGGG
CTTCGATGTGCCCCACCTT: TTCGATGTGCCCCACCTTT
CTTCGCAGCCCGCGGATCT: TTCGCAGCCCGCGGATCTA
CTTCGCTGGATGACCTTGA: TTCGCTGGATGACCTTGAG
CTTCGTAGCTTTGAGATCG: TTCGTAGCTTTGAGATCGC
CTTCTCGATCGCTGTCCTC: TTCTCGATCGCTGTCCTCT
CTTGAATGATCGTGTATCG: TTGAATGATCGTGTATCGT
CTTGAGGAGCTTACCATGA: TTGAGGAGCTTACCATGAT
CTTGATGGTCGCCGCGTAA: TTGATGGTCGCCGCGTAAA
CTTGCAGATAATTATGAGT: TTGCAGATAATTATGAGTC
CTTGCAGCAATTGTGTTTC: TTGCAGCAATTGTGTTTCT
CTTGGCTTCAGTCCCCTCG: TTGGCTTCAGTCCCCTCGA
CTTGGTCGCTTAGGCTAAG: TTGGTCGCTTAGGCTAAGA
CTTGGTGCCGCTTCGTAGC: TTGGTGCCGCTTCGTAGCT
CTTGTGACCCCATAAGGAA: TTGTGACCCCATAAGGAAT
CTTTAACCTATACCCAGCA: TTTAACCTATACCCAGCAC
CTTTAGTTGGCCCTATATA: TTTAGTTGGCCCTATATAG
CTTTGAGATCGCTTGGCTT: TTTGAGATCGCTTGGCTTC
CTTTGATTCGCAATGAAAC: TTTGATTCGCAATGAAACC
CTTTGCGCTGCGCAAGAAC: TTTGCGCTGCGCAAGAACC
CTTTGGACTGGGCGTAAAC: TTTGGACTGGGCGTAAACC
CTTTGGCTAATTTCTGACT: TTTGGCTAATTTCTGACTG
CTTTGTGTCAATCCGCCCC: TTTGTGTCAATCCGCCCCG
CTTTGTTCGGGACTTTAAC: TTTGTTCGGGACTTTAACC
CTTTTCTAGATGTTGGAGC: TTTTCTAGATGTTGGAGCG
CTTTTGAAGCAAAATTGAC: TTTTGAAGCAAAATTGACT
GAAAAAGCCCAATATGCGA: AAAAAGCCCAATATGCGAG
GAAAAGTAAGCCTGCTCGC: AAAAGTAAGCCTGCTCGCA
GAAAATTGCTTCGAGGAGG: AAAATTGCTTCGAGGAGGA
GAAACCTATACCCAGCACT: AAACCTATACCCAGCACTG
GAAACTTCGATGTGCCCCA: AAACTTCGATGTGCCCCAC
GAAAGCTGCGTAGACAAAT: AAAGCTGCGTAGACAAATA
GAAAGGTACGTTCAAGTAT: AAAGGTACGTTCAAGTATG
GAAAGTCGCTATTAGGGTA: AAAGTCGCTATTAGGGTAG
GAAAGTTGAGCAACCCGCG: AAAGTTGAGCAACCCGCGC
GAAATACAAGCTAGCCAAT: AAATACAAGCTAGCCAATG
GAAATCATCGGGCGTGTGC: AAATCATCGGGCGTGTGCT
GAAATCCTGCGGGCTTCCT: AAATCCTGCGGGCTTCCTA
GAAATGTCGGAAATCCTGC: AAATGTCGGAAATCCTGCG
GAAATTTCAGATCATTGTC: AAATTTCAGATCATTGTCA
GAACAGAGCTCATTCTAAC: AACAGAGCTCATTCTAACG
GAACAGCACCTGGCAAATT: AACAGCACCTGGCAAATTT
GAACAGGACCTGTAGCTAG: AACAGGACCTGTAGCTAGG
GAACAGTATAGTCGATGAT: AACAGTATAGTCGATGATC
GAACAGTTAGATAGTATCT: AACAGTTAGATAGTATCTG
GAACCACTTTAGTTGGCCC: AACCACTTTAGTTGGCCCT
GAACCTATACCCAGCACTG: AACCTATACCCAGCACTGG
GAACGTACCAATGCCCTAC: AACGTACCAATGCCCTACC
GAACGTCACTTAAACCAGG: AACGTCACTTAAACCAGGC
GAAGAACGTACCAATGCCC: AAGAACGTACCAATGCCCT
GAAGATGTAACTGAAGCGT: AAGATGTAACTGAAGCGTT
GAAGCAAAATTGACTCGAT: AAGCAAAATTGACTCGATT
GAAGCAATAGATCGGGAAG: AAGCAATAGATCGGGAAGA
GAAGCGGTAACATGTAGAC: AAGCGGTAACATGTAGACA
GAAGCGTTCACTTAGAGTG: AAGCGTTCACTTAGAGTGC
GAAGGTTGGGAGTCTCACA: AAGGTTGGGAGTCTCACAA
GAAGTATACTCTGTACTGG: AAGTATACTCTGTACTGGC
GAATCGGGGAGACTAGGCT: AATCGGGGAGACTAGGCTT
GAATCTCGCTTTGGCTAAT: AATCTCGCTTTGGCTAATT
GAATCTGGGCAACACTTGC: AATCTGGGCAACACTTGCA
GAATGATAAGAATCGGGGA: AATGATAAGAATCGGGGAG
GAATGATCGTGTATCGTTA: AATGATCGTGTATCGTTAG
GAATGGCACTTACGCTTCT: AATGGCACTTACGCTTCTC
GAATTGCATGCGCTGAAAT: AATTGCATGCGCTGAAATG
GACAAATACTTACATCATA: ACAAATACTTACATCATAG
GACACGGCCATCTCCTAGT: ACACGGCCATCTCCTAGTA
GACACTTATAGGGGCCGCT: ACACTTATAGGGGCCGCTT
GACAGCACGGACCAATGTT: ACAGCACGGACCAATGTTT
GACAGCGAAGCAATAGATC: ACAGCGAAGCAATAGATCG
GACATATTCCCAGTTGATT: ACATATTCCCAGTTGATTA
GACATGGGTAGAACAGGAC: ACATGGGTAGAACAGGACC
GACATTGGTGCACCTGTAT: ACATTGGTGCACCTGTATC
GACCAAGGGGGCAAAGTTT: ACCAAGGGGGCAAAGTTTT
GACCAATGTTTCGGCGAAT: ACCAATGTTTCGGCGAATG
GACCACGTGGCGTAGCGCC: ACCACGTGGCGTAGCGCCT
GACCCCAATCGTCTCGCGT: ACCCCAATCGTCTCGCGTG
GACCCCATAAGGAATCTGG: ACCCCATAAGGAATCTGGG
GACCCGATGCCTGATCACG: ACCCGATGCCTGATCACGC
GACCTGTAGCTAGGGACGA: ACCTGTAGCTAGGGACGAC
GACCTTATTACATGCGTCA: ACCTTATTACATGCGTCAT
GACCTTGAGGAGCTTACCA: ACCTTGAGGAGCTTACCAT
GACGAACAGCACCTGGCAA: ACGAACAGCACCTGGCAAA
GACGACGATGGTATTAGAG: ACGACGATGGTATTAGAGC
GACGATGTGCCCCACCTTT: ACGATGTGCCCCACCTTTG
GACGGTTTGGTTCTCTCAC: ACGGTTTGGTTCTCTCACC
GACGTAGTCATCAACATGT: ACGTAGTCATCAACATGTC
GACTAGGCTTTTGAAGCAA: ACTAGGCTTTTGAAGCAAA
GACTCCAGCGACGGTTTGG: ACTCCAGCGACGGTTTGGT
GACTCGATTGAGCATATTG: ACTCGATTGAGCATATTGA
GACTCTTGTGACCCCATAA: ACTCTTGTGACCCCATAAG
GACTGGGCGTAAACCTATA: ACTGGGCGTAAACCTATAC
GACTGGTATCTAGAAGTAT: ACTGGTATCTAGAAGTATA
GACTTTAACCTATACCCAG: ACTTTAACCTATACCCAGC
GAGAACGTCACTTAAACCA: AGAACGTCACTTAAACCAG
GAGAAGGTTGGGAGTCTCA: AGAAGGTTGGGAGTCTCAC
GAGACATATTCCCAGTTGA: AGACATATTCCCAGTTGAT
GAGACTAGGCTTTTGAAGC: AGACTAGGCTTTTGAAGCA
GAGAGGCAACGACATTGGT: AGAGGCAACGACATTGGTG
GAGATCGCTTGGCTTCAGT: AGATCGCTTGGCTTCAGTC
GAGCAACCCGCGCTCAGAT: AGCAACCCGCGCTCAGATC
GAGCACGAAAATTGCTTCG: AGCACGAAAATTGCTTCGA
GAGCATATTGAAGCGGTAA: AGCATATTGAAGCGGTAAC
GAGCGATGTGCCCCACCTT: AGCGATGTGCCCCACCTTT
GAGCGCAGCTAAGAAGAAC: AGCGCAGCTAAGAAGAACG
GAGCGCGAGAGGCAACGAC: AGCGCGAGAGGCAACGACA
GAGCTCATTCTAACGTAAA: AGCTCATTCTAACGTAAAC
GAGCTTACCATGATGTTCG: AGCTTACCATGATGTTCGA
GAGGACCAAGGGGGCAAAG: AGGACCAAGGGGGCAAAGT
GAGGAGCTTACCATGATGT: AGGAGCTTACCATGATGTT
GAGGAGGACCAAGGGGGCA: AGGAGGACCAAGGGGGCAA
GAGGCAACGACATTGGTGC: AGGCAACGACATTGGTGCA
GAGGGTGAGTAGTGTTTCA: AGGGTGAGTAGTGTTTCAA
GAGGTCCATACGAGAAGGT: AGGTCCATACGAGAAGGTT
GAGGTGTCCGGTTCGAACA: AGGTGTCCGGTTCGAACAG
GAGTAACCAACATCAGAGC: AGTAACCAACATCAGAGCG
GAGTAGTGTTTCAAAGAAT: AGTAGTGTTTCAAAGAATT
GAGTCAAACCTATCGCATG: AGTCAAACCTATCGCATGC
GAGTCCCACAGCGCTACAG: AGTCCCACAGCGCTACAGT
GAGTCTAACGTTCTTCATT: AGTCTAACGTTCTTCATTG
GAGTCTCACAAGTATAAGA: AGTCTCACAAGTATAAGAT
GAGTCTGTGTATTAATCAG: AGTCTGTGTATTAATCAGT
GAGTGAGCGATGTGCCCCA: AGTGAGCGATGTGCCCCAC
GAGTGAGGTGTCCGGTTCG: AGTGAGGTGTCCGGTTCGA
GAGTGCAGCATTATCCTGA: AGTGCAGCATTATCCTGAA
GATAAGAATCGGGGAGACT: ATAAGAATCGGGGAGACTA
GATAAGGGTTATCCGACCA: ATAAGGGTTATCCGACCAC
GATAATATCGCGTCACATT: ATAATATCGCGTCACATTC
GATAATTATGAGTCAAACC: ATAATTATGAGTCAAACCT
GATACTGCGTGCAAGCATT: ATACTGCGTGCAAGCATTT
GATAGTATCTGGAAATCAT: ATAGTATCTGGAAATCATC
GATCACGCCACGAGTGAGC: ATCACGCCACGAGTGAGCG
GATCAGTCGAGTAACCAAC: ATCAGTCGAGTAACCAACA
GATCAGTCTCGTTTGGGGT: ATCAGTCTCGTTTGGGGTT
GATCATTGTCAGATTCCAG: ATCATTGTCAGATTCCAGC
GATCCGATCGGGATACTGC: ATCCGATCGGGATACTGCG
GATCCTTCGCTGGATGACC: ATCCTTCGCTGGATGACCT
GATCGCTGTCCTCTCCGAT: ATCGCTGTCCTCTCCGATG
GATCGCTTGGCTTCAGTCC: ATCGCTTGGCTTCAGTCCC
GATCGGGAAGATGTAACTG: ATCGGGAAGATGTAACTGA
GATCGGGATACTGCGTGCA: ATCGGGATACTGCGTGCAA
GATCGTGTATCGTTAGGGT: ATCGTGTATCGTTAGGGTC
GATCTAATAGTCCACTCTA: ATCTAATAGTCCACTCTAA
GATCTACCGTACGGGATGG: ATCTACCGTACGGGATGGG
GATCTGACGTAGTCATCAA: ATCTGACGTAGTCATCAAC
GATCTGCCCCAGCTCCACT: ATCTGCCCCAGCTCCACTT
GATGACCTTGAGGAGCTTA: ATGACCTTGAGGAGCTTAC
GATGACGATGTGCCCCACC: ATGACGATGTGCCCCACCT
GATGATCTAATAGTCCACT: ATGATCTAATAGTCCACTC
GATGCCTGATCACGCCACG: ATGCCTGATCACGCCACGA
GATGGCGTCTGGTTGGTAT: ATGGCGTCTGGTTGGTATA
GATGGGGTTATTTTGCCCC: ATGGGGTTATTTTGCCCCA
GATGGTCGCCGCGTAAAGC: ATGGTCGCCGCGTAAAGCT
GATGTAACTGAAGCGTTCA: ATGTAACTGAAGCGTTCAC
GATGTGCCCCACCTTTGAT: ATGTGCCCCACCTTTGATT
GATGTGCCCCACCTTTGCG: ATGTGCCCCACCTTTGCGC
GATGTGCCCCACCTTTGGA: ATGTGCCCCACCTTTGGAC
GATGTGCCCCACCTTTGTT: ATGTGCCCCACCTTTGTTC
GATGTTCGACCCCAATCGT: ATGTTCGACCCCAATCGTC
GATGTTGGAGCGCGAGAGG: ATGTTGGAGCGCGAGAGGC
GATTAGGAACAGTTAGATA: ATTAGGAACAGTTAGATAG
GATTCCAGCGTTTAGGGCA: ATTCCAGCGTTTAGGGCAG
GATTCGCAATGAAACCTAT: ATTCGCAATGAAACCTATA
GATTGAGCATATTGAAGCG: ATTGAGCATATTGAAGCGG
GATTTCGATCAGTCGAGTA: ATTTCGATCAGTCGAGTAA
GCAAAATTGACTCGATTGA: CAAAATTGACTCGATTGAG
GCAAACTTTGTGTCAATCC: CAAACTTTGTGTCAATCCG
GCAAAGTTTTCCAGCAAGA: CAAAGTTTTCCAGCAAGAG
GCAAATTTGAGAACGTCAC: CAAATTTGAGAACGTCACT
GCAACACTTGCAGATAATT: CAACACTTGCAGATAATTA
GCAACCATTTTTACTTCGC: CAACCATTTTTACTTCGCA
GCAACCCGCGCTCAGATCT: CAACCCGCGCTCAGATCTG
GCAACGACATTGGTGCACC: CAACGACATTGGTGCACCT
GCAAGAACCTATACCCAGC: CAAGAACCTATACCCAGCA
GCAAGAGTCTGTGTATTAA: CAAGAGTCTGTGTATTAAT
GCAAGCATTTGGTGAGGGT: CAAGCATTTGGTGAGGGTG
GCAATAGATCGGGAAGATG: CAATAGATCGGGAAGATGT
GCAATGAAACCTATACCCA: CAATGAAACCTATACCCAG
GCAATTGTGTTTCTCAGTC: CAATTGTGTTTCTCAGTCA
GCACCGTTCGGATCTGCCC: CACCGTTCGGATCTGCCCC
GCACCTGGCAAATTTGAGA: CACCTGGCAAATTTGAGAA
GCACCTGTATCTCGAAACT: CACCTGTATCTCGAAACTT
GCACGAAAATTGCTTCGAG: CACGAAAATTGCTTCGAGG
GCACGGACCAATGTTTCGG: CACGGACCAATGTTTCGGC
GCACGTTTTGTCCAGCGTG: CACGTTTTGTCCAGCGTGA
GCACTGGATCAGTCTCGTT: CACTGGATCAGTCTCGTTT
GCACTGGTCATTAGGCAGT: CACTGGTCATTAGGCAGTC
GCACTGGTCTGGTGAAATA: CACTGGTCTGGTGAAATAC
GCACTGGTTCCGTTACGAA: CACTGGTTCCGTTACGAAA
GCACTTACGCTTCTCGATC: CACTTACGCTTCTCGATCG
GCAGAATGGCACTTACGCT: CAGAATGGCACTTACGCTT
GCAGAGTCCCACAGCGCTA: CAGAGTCCCACAGCGCTAC
GCAGATAATTATGAGTCAA: CAGATAATTATGAGTCAAA
GCAGCAATTGTGTTTCTCA: CAGCAATTGTGTTTCTCAG
GCAGCATTATCCTGAACCA: CAGCATTATCCTGAACCAC
GCAGCCCGCGGATCTACCG: CAGCCCGCGGATCTACCGT
GCAGCTAAGAAGAACGTAC: CAGCTAAGAAGAACGTACC
GCAGCTCACAATTATCACC: CAGCTCACAATTATCACCG
GCAGTCTTGGTCGCTTAGG: CAGTCTTGGTCGCTTAGGC
GCAGTTTAATTCAGAGCAC: CAGTTTAATTCAGAGCACG
GCATATTGAAGCGGTAACA: CATATTGAAGCGGTAACAT
GCATGCGCTGAAATGTCGG: CATGCGCTGAAATGTCGGA
GCATGCGTGTTGAAAGTTG: CATGCGTGTTGAAAGTTGA
GCATGCTAACTGAAAGGTA: CATGCTAACTGAAAGGTAC
GCATTATCCTGAACCACTT: CATTATCCTGAACCACTTT
GCATTTGGTGAGGGTGAGT: CATTTGGTGAGGGTGAGTA
GCCAATGTGTTGCGCGCAC: CCAATGTGTTGCGCGCACC
GCCACGAGTGAGCGATGTG: CCACGAGTGAGCGATGTGC
GCCATCTCCTAGTAGCAAA: CCATCTCCTAGTAGCAAAC
GCCCAATATGCGAGTGAGG: CCCAATATGCGAGTGAGGT
GCCCCACCTTTGATTCGCA: CCCCACCTTTGATTCGCAA
GCCCCACCTTTGCGCTGCG: CCCCACCTTTGCGCTGCGC
GCCCCACCTTTGGACTGGG: CCCCACCTTTGGACTGGGC
GCCCCACCTTTGTTCGGGA: CCCCACCTTTGTTCGGGAC
GCCCCACTTCCATCGACGA: CCCCACTTCCATCGACGAA
GCCCCAGCTCCACTTGGTG: CCCCAGCTCCACTTGGTGC
GCCCCGAGACATATTCCCA: CCCCGAGACATATTCCCAG
GCCCCGGATCCGATCGGGA: CCCCGGATCCGATCGGGAT
GCCCGCGGATCTACCGTAC: CCCGCGGATCTACCGTACG
GCCCGGGTTCCACTCCCAG: CCCGGGTTCCACTCCCAGT
GCCCGTAACGCTGTAAGAC: CCCGTAACGCTGTAAGACA
GCCCTACCCGGTATATCGT: CCCTACCCGGTATATCGTT
GCCCTATATAGCTCGCAGT: CCCTATATAGCTCGCAGTT
GCCGCGTAAAGCTAGTTCG: CCGCGTAAAGCTAGTTCGC
GCCGCTTAGTCATCGCTGA: CCGCTTAGTCATCGCTGAG
GCCGCTTCGTAGCTTTGAG: CCGCTTCGTAGCTTTGAGA
GCCGTATACAAGGCGTGGT: CCGTATACAAGGCGTGGTT
GCCTCCTATCTTTTCTAGA: CCTCCTATCTTTTCTAGAT
GCCTCGGACTCCAGCGACG: CCTCGGACTCCAGCGACGG
GCCTGATCACGCCACGAGT: CCTGATCACGCCACGAGTG
GCCTGCTCGCACGTTTTGT: CCTGCTCGCACGTTTTGTC
GCGAAGCAATAGATCGGGA: CGAAGCAATAGATCGGGAA
GCGAATGATAAGAATCGGG: CGAATGATAAGAATCGGGG
GCGACGGTTTGGTTCTCTC: CGACGGTTTGGTTCTCTCA
GCGAGAGGCAACGACATTG: CGAGAGGCAACGACATTGG
GCGAGTGAGGTGTCCGGTT: CGAGTGAGGTGTCCGGTTC
GCGATGTGCCCCACCTTTG: CGATGTGCCCCACCTTTGG
GCGCAAGAACCTATACCCA: CGCAAGAACCTATACCCAG
GCGCACCGTTCGGATCTGC: CGCACCGTTCGGATCTGCC
GCGCAGCTAAGAAGAACGT: CGCAGCTAAGAAGAACGTA
GCGCCCCGGATCCGATCGG: CGCCCCGGATCCGATCGGG
GCGCCTCCTATCTTTTCTA: CGCCTCCTATCTTTTCTAG
GCGCGAGAGGCAACGACAT: CGCGAGAGGCAACGACATT
GCGCGCACCGTTCGGATCT: CGCGCACCGTTCGGATCTG
GCGCTACAGTCAGCGCCCC: CGCTACAGTCAGCGCCCCG
GCGCTCAGATCTGACGTAG: CGCTCAGATCTGACGTAGT
GCGCTGAAATGTCGGAAAT: CGCTGAAATGTCGGAAATC
GCGCTGCGCAAGAACCTAT: CGCTGCGCAAGAACCTATA
GCGGATCTACCGTACGGGA: CGGATCTACCGTACGGGAT
GCGGGCTTCCTATCGAACA: CGGGCTTCCTATCGAACAG
GCGGGTCGGGCCCGGGTTC: CGGGTCGGGCCCGGGTTCC
GCGGTAACATGTAGACACG: CGGTAACATGTAGACACGG
GCGTAAACCTATACCCAGC: CGTAAACCTATACCCAGCA
GCGTAAAGCTAGTTCGCCG: CGTAAAGCTAGTTCGCCGT
GCGTAGACAAATACTTACA: CGTAGACAAATACTTACAT
GCGTAGCGCCTCCTATCTT: CGTAGCGCCTCCTATCTTT
GCGTCACATTCTTGAATGA: CGTCACATTCTTGAATGAT
GCGTCATTGATGACGATGT: CGTCATTGATGACGATGTG
GCGTCTGGTTGGTATAGCC: CGTCTGGTTGGTATAGCCC
GCGTGACATGGGTAGAACA: CGTGACATGGGTAGAACAG
GCGTGCAAGCATTTGGTGA: CGTGCAAGCATTTGGTGAG
GCGTGGGGCGGGTCGGGCC: CGTGGGGCGGGTCGGGCCC
GCGTGGTTTGCAGAATGGC: CGTGGTTTGCAGAATGGCA
GCGTGTGCTGCAGAGTCCC: CGTGTGCTGCAGAGTCCCA
GCGTGTTGAAAGTTGAGCA: CGTGTTGAAAGTTGAGCAA
GCGTTCACTTAGAGTGCAG: CGTTCACTTAGAGTGCAGC
GCGTTTAGGGCAGCTCACA: CGTTTAGGGCAGCTCACAA
GCGTTTGTCCCTATGGAAT: CGTTTGTCCCTATGGAATC
GCTAACTGAAAGGTACGTT: CTAACTGAAAGGTACGTTC
GCTAAGAAAAAGCCCAATA: CTAAGAAAAAGCCCAATAT
GCTAAGAAGAACGTACCAA: CTAAGAAGAACGTACCAAT
GCTAATTTCTGACTGGTAT: CTAATTTCTGACTGGTATC
GCTACAGTCAGCGCCCCGG: CTACAGTCAGCGCCCCGGA
GCTAGCCAATGTGTTGCGC: CTAGCCAATGTGTTGCGCG
GCTAGGCGTTTGTCCCTAT: CTAGGCGTTTGTCCCTATG
GCTAGGGACGACGATGGTA: CTAGGGACGACGATGGTAT
GCTAGTTCGCCGTATACAA: CTAGTTCGCCGTATACAAG
GCTATTAGGGTAGGCAACC: CTATTAGGGTAGGCAACCA
GCTCAACTAGACCCGATGC: CTCAACTAGACCCGATGCC
GCTCACAATTATCACCGCC: CTCACAATTATCACCGCCT
GCTCAGATCTGACGTAGTC: CTCAGATCTGACGTAGTCA
GCTCATTCTAACGTAAACA: CTCATTCTAACGTAAACAG
GCTCCACTTGGTGCCGCTT: CTCCACTTGGTGCCGCTTC
GCTCGCACGTTTTGTCCAG: CTCGCACGTTTTGTCCAGC
GCTCGCAGTTTAATTCAGA: CTCGCAGTTTAATTCAGAG
GCTGAAATGTCGGAAATCC: CTGAAATGTCGGAAATCCT
GCTGACCTTATTACATGCG: CTGACCTTATTACATGCGT
GCTGAGGTCCATACGAGAA: CTGAGGTCCATACGAGAAG
GCTGCAGAGTCCCACAGCG: CTGCAGAGTCCCACAGCGC
GCTGCGCAAGAACCTATAC: CTGCGCAAGAACCTATACC
GCTGCGTAGACAAATACTT: CTGCGTAGACAAATACTTA
GCTGGATGACCTTGAGGAG: CTGGATGACCTTGAGGAGC
GCTGTAAGACAGCACGGAC: CTGTAAGACAGCACGGACC
GCTGTCCTCTCCGATGTGC: CTGTCCTCTCCGATGTGCC
GCTTACCATGATGTTCGAC: CTTACCATGATGTTCGACC
GCTTAGGCTAAGAAAAAGC: CTTAGGCTAAGAAAAAGCC
GCTTAGTCATCGCTGAGGT: CTTAGTCATCGCTGAGGTC
GCTTCAGTCCCCTCGATAA: CTTCAGTCCCCTCGATAAT
GCTTCCTATCGAACAGAGC: CTTCCTATCGAACAGAGCT
GCTTCGAGGAGGACCAAGG: CTTCGAGGAGGACCAAGGG
GCTTCGTAGCTTTGAGATC: CTTCGTAGCTTTGAGATCG
GCTTCTCGATCGCTGTCCT: CTTCTCGATCGCTGTCCTC
GCTTGGCTTCAGTCCCCTC: CTTGGCTTCAGTCCCCTCG
GCTTTGAGATCGCTTGGCT: CTTTGAGATCGCTTGGCTT
GCTTTGGCTAATTTCTGAC: CTTTGGCTAATTTCTGACT
GCTTTTGAAGCAAAATTGA: CTTTTGAAGCAAAATTGAC
GGAAATCATCGGGCGTGTG: GAAATCATCGGGCGTGTGC
GGAAATCCTGCGGGCTTCC: GAAATCCTGCGGGCTTCCT
GGAACAGTTAGATAGTATC: GAACAGTTAGATAGTATCT
GGAAGATGTAACTGAAGCG: GAAGATGTAACTGAAGCGT
GGAATCTCGCTTTGGCTAA: GAATCTCGCTTTGGCTAAT
GGAATCTGGGCAACACTTG: GAATCTGGGCAACACTTGC
GGACACTTATAGGGGCCGC: GACACTTATAGGGGCCGCT
GGACCAAGGGGGCAAAGTT: GACCAAGGGGGCAAAGTTT
GGACCAATGTTTCGGCGAA: GACCAATGTTTCGGCGAAT
GGACCTGTAGCTAGGGACG: GACCTGTAGCTAGGGACGA
GGACGACGATGGTATTAGA: GACGACGATGGTATTAGAG
GGACTCCAGCGACGGTTTG: GACTCCAGCGACGGTTTGG
GGACTGGGCGTAAACCTAT: GACTGGGCGTAAACCTATA
GGACTTTAACCTATACCCA: GACTTTAACCTATACCCAG
GGAGACTAGGCTTTTGAAG: GAGACTAGGCTTTTGAAGC
GGAGCGCGAGAGGCAACGA: GAGCGCGAGAGGCAACGAC
GGAGCTTACCATGATGTTC: GAGCTTACCATGATGTTCG
GGAGGACCAAGGGGGCAAA: GAGGACCAAGGGGGCAAAG
GGAGTCTCACAAGTATAAG: GAGTCTCACAAGTATAAGA
GGATACTGCGTGCAAGCAT: GATACTGCGTGCAAGCATT
GGATCAGTCTCGTTTGGGG: GATCAGTCTCGTTTGGGGT
GGATCCGATCGGGATACTG: GATCCGATCGGGATACTGC
GGATCCTTCGCTGGATGAC: GATCCTTCGCTGGATGACC
GGATCTACCGTACGGGATG: GATCTACCGTACGGGATGG
GGATCTGCCCCAGCTCCAC: GATCTGCCCCAGCTCCACT
GGATGACCTTGAGGAGCTT: GATGACCTTGAGGAGCTTA
GGATGGGGTTATTTTGCCC: GATGGGGTTATTTTGCCCC
GGCAAAGTTTTCCAGCAAG: GCAAAGTTTTCCAGCAAGA
GGCAAATTTGAGAACGTCA: GCAAATTTGAGAACGTCAC
GGCAACACTTGCAGATAAT: GCAACACTTGCAGATAATT
GGCAACCATTTTTACTTCG: GCAACCATTTTTACTTCGC
GGCAACGACATTGGTGCAC: GCAACGACATTGGTGCACC
GGCACTTACGCTTCTCGAT: GCACTTACGCTTCTCGATC
GGCAGCTCACAATTATCAC: GCAGCTCACAATTATCACC
GGCAGTCTTGGTCGCTTAG: GCAGTCTTGGTCGCTTAGG
GGCATGCTAACTGAAAGGT: GCATGCTAACTGAAAGGTA
GGCCATCTCCTAGTAGCAA: GCCATCTCCTAGTAGCAAA
GGCCCGGGTTCCACTCCCA: GCCCGGGTTCCACTCCCAG
GGCCCTATATAGCTCGCAG: GCCCTATATAGCTCGCAGT
GGCCGCTTAGTCATCGCTG: GCCGCTTAGTCATCGCTGA
GGCGAATGATAAGAATCGG: GCGAATGATAAGAATCGGG
GGCGGGTCGGGCCCGGGTT: GCGGGTCGGGCCCGGGTTC
GGCGTAAACCTATACCCAG: GCGTAAACCTATACCCAGC
GGCGTAGCGCCTCCTATCT: GCGTAGCGCCTCCTATCTT
GGCGTCTGGTTGGTATAGC: GCGTCTGGTTGGTATAGCC
GGCGTGGTTTGCAGAATGG: GCGTGGTTTGCAGAATGGC
GGCGTGTGCTGCAGAGTCC: GCGTGTGCTGCAGAGTCCC
GGCGTTTGTCCCTATGGAA: GCGTTTGTCCCTATGGAAT
GGCTAAGAAAAAGCCCAAT: GCTAAGAAAAAGCCCAATA
GGCTAATTTCTGACTGGTA: GCTAATTTCTGACTGGTAT
GGCTAGGCGTTTGTCCCTA: GCTAGGCGTTTGTCCCTAT
GGCTTCAGTCCCCTCGATA: GCTTCAGTCCCCTCGATAA
GGCTTCCTATCGAACAGAG: GCTTCCTATCGAACAGAGC
GGCTTTTGAAGCAAAATTG: GCTTTTGAAGCAAAATTGA
GGGAAGATGTAACTGAAGC: GGAAGATGTAACTGAAGCG
GGGACACTTATAGGGGCCG: GGACACTTATAGGGGCCGC
GGGACGACGATGGTATTAG: GGACGACGATGGTATTAGA
GGGACTTTAACCTATACCC: GGACTTTAACCTATACCCA
GGGAGACTAGGCTTTTGAA: GGAGACTAGGCTTTTGAAG
GGGAGTCTCACAAGTATAA: GGAGTCTCACAAGTATAAG
GGGATACTGCGTGCAAGCA: GGATACTGCGTGCAAGCAT
GGGATGGGGTTATTTTGCC: GGATGGGGTTATTTTGCCC
GGGCAAAGTTTTCCAGCAA: GGCAAAGTTTTCCAGCAAG
GGGCAACACTTGCAGATAA: GGCAACACTTGCAGATAAT
GGGCAGCTCACAATTATCA: GGCAGCTCACAATTATCAC
GGGCCCGGGTTCCACTCCC: GGCCCGGGTTCCACTCCCA
GGGCCGCTTAGTCATCGCT: GGCCGCTTAGTCATCGCTG
GGGCGGGTCGGGCCCGGGT: GGCGGGTCGGGCCCGGGTT
GGGCGTAAACCTATACCCA: GGCGTAAACCTATACCCAG
GGGCGTGTGCTGCAGAGTC: GGCGTGTGCTGCAGAGTCC
GGGCTTCCTATCGAACAGA: GGCTTCCTATCGAACAGAG
GGGGAGACTAGGCTTTTGA: GGGAGACTAGGCTTTTGAA
GGGGCAAAGTTTTCCAGCA: GGGCAAAGTTTTCCAGCAA
GGGGCCGCTTAGTCATCGC: GGGCCGCTTAGTCATCGCT
GGGGCGGGTCGGGCCCGGG: GGGCGGGTCGGGCCCGGGT
GGGGGCAAAGTTTTCCAGC: GGGGCAAAGTTTTCCAGCA
GGGGTTATTTTGCCCCACT: GGGTTATTTTGCCCCACTT
GGGGTTGCTGACCTTATTA: GGGTTGCTGACCTTATTAC
GGGTAGAACAGGACCTGTA: GGTAGAACAGGACCTGTAG
GGGTAGGCAACCATTTTTA: GGTAGGCAACCATTTTTAC
GGGTCGGGCCCGGGTTCCA: GGTCGGGCCCGGGTTCCAC
GGGTCTGTGACAGCGAAGC: GGTCTGTGACAGCGAAGCA
GGGTGAGTAGTGTTTCAAA: GGTGAGTAGTGTTTCAAAG
GGGTTATCCGACCACGTGG: GGTTATCCGACCACGTGGC
GGGTTATTTTGCCCCACTT: GGTTATTTTGCCCCACTTC
GGGTTCCACTCCCAGTTCA: GGTTCCACTCCCAGTTCAA
GGGTTCGCTCAACTAGACC: GGTTCGCTCAACTAGACCC
GGGTTGCTGACCTTATTAC: GGTTGCTGACCTTATTACA
GGTAACATGTAGACACGGC: GTAACATGTAGACACGGCC
GGTACGTTCAAGTATGGGA: GTACGTTCAAGTATGGGAC
GGTAGAACAGGACCTGTAG: GTAGAACAGGACCTGTAGC
GGTAGGCAACCATTTTTAC: GTAGGCAACCATTTTTACT
GGTATAGCCCGTAACGCTG: GTATAGCCCGTAACGCTGT
GGTATATCGTTAGAGTCTA: GTATATCGTTAGAGTCTAA
GGTATCTAGAAGTATACTC: GTATCTAGAAGTATACTCT
GGTCATTAGGCAGTCTTGG: GTCATTAGGCAGTCTTGGT
GGTCCATACGAGAAGGTTG: GTCCATACGAGAAGGTTGG
GGTCGCCGCGTAAAGCTAG: GTCGCCGCGTAAAGCTAGT
GGTCGCTTAGGCTAAGAAA: GTCGCTTAGGCTAAGAAAA
GGTCGGGCCCGGGTTCCAC: GTCGGGCCCGGGTTCCACT
GGTCTGGTGAAATACAAGC: GTCTGGTGAAATACAAGCT
GGTCTGTGACAGCGAAGCA: GTCTGTGACAGCGAAGCAA
GGTGAAATACAAGCTAGCC: GTGAAATACAAGCTAGCCA
GGTGAGGGTGAGTAGTGTT: GTGAGGGTGAGTAGTGTTT
GGTGAGTAGTGTTTCAAAG: GTGAGTAGTGTTTCAAAGA
GGTGCACCTGTATCTCGAA: GTGCACCTGTATCTCGAAA
GGTGCCGCTTCGTAGCTTT: GTGCCGCTTCGTAGCTTTG
GGTGTCCGGTTCGAACAGT: GTGTCCGGTTCGAACAGTA
GGTTATCCGACCACGTGGC: GTTATCCGACCACGTGGCG
GGTTATTTTGCCCCACTTC: GTTATTTTGCCCCACTTCC
GGTTCCACTCCCAGTTCAA: GTTCCACTCCCAGTTCAAC
GGTTCCGTTACGAAAGCTG: GTTCCGTTACGAAAGCTGC
GGTTCGAACAGTATAGTCG: GTTCGAACAGTATAGTCGA
GGTTCGCTCAACTAGACCC: GTTCGCTCAACTAGACCCG
GGTTCTCTCACCGACTCTT: GTTCTCTCACCGACTCTTG
GGTTGCTGACCTTATTACA: GTTGCTGACCTTATTACAT
GGTTGGGAGTCTCACAAGT: GTTGGGAGTCTCACAAGTA
GGTTGGTATAGCCCGTAAC: GTTGGTATAGCCCGTAACG
GGTTTGCAGAATGGCACTT: GTTTGCAGAATGGCACTTA
GGTTTGGTTCTCTCACCGA: GTTTGGTTCTCTCACCGAC
GTAAACAGAAATTTCAGAT: TAAACAGAAATTTCAGATC
GTAAACCTATACCCAGCAC: TAAACCTATACCCAGCACT
GTAAAGCTAGTTCGCCGTA: TAAAGCTAGTTCGCCGTAT
GTAACATGTAGACACGGCC: TAACATGTAGACACGGCCA
GTAACCAACATCAGAGCGC: TAACCAACATCAGAGCGCA
GTAACGCTGTAAGACAGCA: TAACGCTGTAAGACAGCAC
GTAACTGAAGCGTTCACTT: TAACTGAAGCGTTCACTTA
GTAAGACAGCACGGACCAA: TAAGACAGCACGGACCAAT
GTAAGCCTGCTCGCACGTT: TAAGCCTGCTCGCACGTTT
GTACCAATGCCCTACCCGG: TACCAATGCCCTACCCGGT
GTACGGGATGGGGTTATTT: TACGGGATGGGGTTATTTT
GTACGTTCAAGTATGGGAC: TACGTTCAAGTATGGGACA
GTACTGGCATGCTAACTGA: TACTGGCATGCTAACTGAA
GTAGAACAGGACCTGTAGC: TAGAACAGGACCTGTAGCT
GTAGACAAATACTTACATC: TAGACAAATACTTACATCA
GTAGACACGGCCATCTCCT: TAGACACGGCCATCTCCTA
GTAGCAAACTTTGTGTCAA: TAGCAAACTTTGTGTCAAT
GTAGCGCCTCCTATCTTTT: TAGCGCCTCCTATCTTTTC
GTAGCTAGGGACGACGATG: TAGCTAGGGACGACGATGG
GTAGCTTTGAGATCGCTTG: TAGCTTTGAGATCGCTTGG
GTAGGCAACCATTTTTACT: TAGGCAACCATTTTTACTT
GTAGTCATCAACATGTCAG: TAGTCATCAACATGTCAGA
GTAGTGTTTCAAAGAATTG: TAGTGTTTCAAAGAATTGC
GTATAAGATTTCGATCAGT: TATAAGATTTCGATCAGTC
GTATACAAGGCGTGGTTTG: TATACAAGGCGTGGTTTGC
GTATACTCTGTACTGGCAT: TATACTCTGTACTGGCATG
GTATAGCCCGTAACGCTGT: TATAGCCCGTAACGCTGTA
GTATAGTCGATGATCTAAT: TATAGTCGATGATCTAATA
GTATATCGTTAGAGTCTAA: TATATCGTTAGAGTCTAAC
GTATCGTTAGGGTCTGTGA: TATCGTTAGGGTCTGTGAC
GTATCTAGAAGTATACTCT: TATCTAGAAGTATACTCTG
GTATCTCGAAACTTCGATG: TATCTCGAAACTTCGATGT
GTATCTGGAAATCATCGGG: TATCTGGAAATCATCGGGC
GTATGGGACACTTATAGGG: TATGGGACACTTATAGGGG
GTATTAATCAGTTGAAAGT: TATTAATCAGTTGAAAGTC
GTCAAACCTATCGCATGCG: TCAAACCTATCGCATGCGT
GTCAATCCGCCCCGAGACA: TCAATCCGCCCCGAGACAT
GTCACATTCTTGAATGATC: TCACATTCTTGAATGATCG
GTCACTTAAACCAGGCTAG: TCACTTAAACCAGGCTAGG
GTCAGAAAAGTAAGCCTGC: TCAGAAAAGTAAGCCTGCT
GTCAGATTCCAGCGTTTAG: TCAGATTCCAGCGTTTAGG
GTCAGCGCCCCGGATCCGA: TCAGCGCCCCGGATCCGAT
GTCAGGGTTCGCTCAACTA: TCAGGGTTCGCTCAACTAG
GTCATCAACATGTCAGAAA: TCATCAACATGTCAGAAAA
GTCATCGCTGAGGTCCATA: TCATCGCTGAGGTCCATAC
GTCATTAGGCAGTCTTGGT: TCATTAGGCAGTCTTGGTC
GTCATTGATGACGATGTGC: TCATTGATGACGATGTGCC
GTCCACTCTAATTCAATCG: TCCACTCTAATTCAATCGG
GTCCAGCGTGACATGGGTA: TCCAGCGTGACATGGGTAG
GTCCATACGAGAAGGTTGG: TCCATACGAGAAGGTTGGG
GTCCCACAGCGCTACAGTC: TCCCACAGCGCTACAGTCA
GTCCCCTCGATAATATCGC: TCCCCTCGATAATATCGCG
GTCCCTATGGAATCTCGCT: TCCCTATGGAATCTCGCTT
GTCCGGTTCGAACAGTATA: TCCGGTTCGAACAGTATAG
GTCCTCTCCGATGTGCCCC: TCCTCTCCGATGTGCCCCA
GTCCTTGCAGCAATTGTGT: TCCTTGCAGCAATTGTGTT
GTCGAGTAACCAACATCAG: TCGAGTAACCAACATCAGA
GTCGATGATCTAATAGTCC: TCGATGATCTAATAGTCCA
GTCGCCGCGTAAAGCTAGT: TCGCCGCGTAAAGCTAGTT
GTCGCTATTAGGGTAGGCA: TCGCTATTAGGGTAGGCAA
GTCGCTTAGGCTAAGAAAA: TCGCTTAGGCTAAGAAAAA
GTCGGAAATCCTGCGGGCT: TCGGAAATCCTGCGGGCTT
GTCGGGCCCGGGTTCCACT: TCGGGCCCGGGTTCCACTC
GTCTAACGTTCTTCATTGT: TCTAACGTTCTTCATTGTC
GTCTCACAAGTATAAGATT: TCTCACAAGTATAAGATTT
GTCTCGCGTGGGGCGGGTC: TCTCGCGTGGGGCGGGTCG
GTCTCGTTTGGGGTTGCTG: TCTCGTTTGGGGTTGCTGA
GTCTGATAAGGGTTATCCG: TCTGATAAGGGTTATCCGA
GTCTGGTGAAATACAAGCT: TCTGGTGAAATACAAGCTA
GTCTGGTTGGTATAGCCCG: TCTGGTTGGTATAGCCCGT
GTCTGTGACAGCGAAGCAA: TCTGTGACAGCGAAGCAAT
GTCTGTGTATTAATCAGTT: TCTGTGTATTAATCAGTTG
GTCTTGGTCGCTTAGGCTA: TCTTGGTCGCTTAGGCTAA
GTGAAATACAAGCTAGCCA: TGAAATACAAGCTAGCCAA
GTGACAGCGAAGCAATAGA: TGACAGCGAAGCAATAGAT
GTGACATGGGTAGAACAGG: TGACATGGGTAGAACAGGA
GTGACCCCATAAGGAATCT: TGACCCCATAAGGAATCTG
GTGAGCGATGTGCCCCACC: TGAGCGATGTGCCCCACCT
GTGAGGGTGAGTAGTGTTT: TGAGGGTGAGTAGTGTTTC
GTGAGGTGTCCGGTTCGAA: TGAGGTGTCCGGTTCGAAC
GTGAGTAGTGTTTCAAAGA: TGAGTAGTGTTTCAAAGAA
GTGCAAGCATTTGGTGAGG: TGCAAGCATTTGGTGAGGG
GTGCACCTGTATCTCGAAA: TGCACCTGTATCTCGAAAC
GTGCAGCATTATCCTGAAC: TGCAGCATTATCCTGAACC
GTGCCCCACCTTTGATTCG: TGCCCCACCTTTGATTCGC
GTGCCCCACCTTTGCGCTG: TGCCCCACCTTTGCGCTGC
GTGCCCCACCTTTGGACTG: TGCCCCACCTTTGGACTGG
GTGCCCCACCTTTGTTCGG: TGCCCCACCTTTGTTCGGG
GTGCCGCTTCGTAGCTTTG: TGCCGCTTCGTAGCTTTGA
GTGCTGCAGAGTCCCACAG: TGCTGCAGAGTCCCACAGC
GTGGCGTAGCGCCTCCTAT: TGGCGTAGCGCCTCCTATC
GTGGGGCGGGTCGGGCCCG: TGGGGCGGGTCGGGCCCGG
GTGGTTTGCAGAATGGCAC: TGGTTTGCAGAATGGCACT
GTGTATCGTTAGGGTCTGT: TGTATCGTTAGGGTCTGTG
GTGTATTAATCAGTTGAAA: TGTATTAATCAGTTGAAAG
GTGTCAATCCGCCCCGAGA: TGTCAATCCGCCCCGAGAC
GTGTCCGGTTCGAACAGTA: TGTCCGGTTCGAACAGTAT
GTGTGCTGCAGAGTCCCAC: TGTGCTGCAGAGTCCCACA
GTGTTGAAAGTTGAGCAAC: TGTTGAAAGTTGAGCAACC
GTGTTGCGCGCACCGTTCG: TGTTGCGCGCACCGTTCGG
GTGTTTCAAAGAATTGCAT: TGTTTCAAAGAATTGCATG
GTGTTTCTCAGTCAGGGTT: TGTTTCTCAGTCAGGGTTC
GTTACGAAAGCTGCGTAGA: TTACGAAAGCTGCGTAGAC
GTTAGAGTCTAACGTTCTT: TTAGAGTCTAACGTTCTTC
GTTAGATAGTATCTGGAAA: TTAGATAGTATCTGGAAAT
GTTAGGGTCTGTGACAGCG: TTAGGGTCTGTGACAGCGA
GTTATCCGACCACGTGGCG: TTATCCGACCACGTGGCGT
GTTATTTTGCCCCACTTCC: TTATTTTGCCCCACTTCCA
GTTCAACTTGATGGTCGCC: TTCAACTTGATGGTCGCCG
GTTCAAGTATGGGACACTT: TTCAAGTATGGGACACTTA
GTTCACTTAGAGTGCAGCA: TTCACTTAGAGTGCAGCAT
GTTCCACTCCCAGTTCAAC: TTCCACTCCCAGTTCAACT
GTTCCGTTACGAAAGCTGC: TTCCGTTACGAAAGCTGCG
GTTCGAACAGTATAGTCGA: TTCGAACAGTATAGTCGAT
GTTCGACCCCAATCGTCTC: TTCGACCCCAATCGTCTCG
GTTCGCCGTATACAAGGCG: TTCGCCGTATACAAGGCGT
GTTCGCTCAACTAGACCCG: TTCGCTCAACTAGACCCGA
GTTCGGATCTGCCCCAGCT: TTCGGATCTGCCCCAGCTC
GTTCGGGACTTTAACCTAT: TTCGGGACTTTAACCTATA
GTTCTCTCACCGACTCTTG: TTCTCTCACCGACTCTTGT
GTTCTTCATTGTCCTTGCA: TTCTTCATTGTCCTTGCAG
GTTGAAAGTCGCTATTAGG: TTGAAAGTCGCTATTAGGG
GTTGAAAGTTGAGCAACCC: TTGAAAGTTGAGCAACCCG
GTTGAGCAACCCGCGCTCA: TTGAGCAACCCGCGCTCAG
GTTGATTAGGAACAGTTAG: TTGATTAGGAACAGTTAGA
GTTGCGCGCACCGTTCGGA: TTGCGCGCACCGTTCGGAT
GTTGCTGACCTTATTACAT: TTGCTGACCTTATTACATG
GTTGGAGCGCGAGAGGCAA: TTGGAGCGCGAGAGGCAAC
GTTGGCCCTATATAGCTCG: TTGGCCCTATATAGCTCGC
GTTGGGAGTCTCACAAGTA: TTGGGAGTCTCACAAGTAT
GTTGGTATAGCCCGTAACG: TTGGTATAGCCCGTAACGC
GTTTAATTCAGAGCACGAA: TTTAATTCAGAGCACGAAA
GTTTAGGGCAGCTCACAAT: TTTAGGGCAGCTCACAATT
GTTTCAAAGAATTGCATGC: TTTCAAAGAATTGCATGCG
GTTTCGGCGAATGATAAGA: TTTCGGCGAATGATAAGAA
GTTTCTCAGTCAGGGTTCG: TTTCTCAGTCAGGGTTCGC
GTTTGCAGAATGGCACTTA: TTTGCAGAATGGCACTTAC
GTTTGGGGTTGCTGACCTT: TTTGGGGTTGCTGACCTTA
GTTTGGTTCTCTCACCGAC: TTTGGTTCTCTCACCGACT
GTTTGTCCCTATGGAATCT: TTTGTCCCTATGGAATCTC
GTTTTCCAGCAAGAGTCTG: TTTTCCAGCAAGAGTCTGT
GTTTTGTCCAGCGTGACAT: TTTTGTCCAGCGTGACATG
TAAACAGAAATTTCAGATC: AAACAGAAATTTCAGATCA
TAAACCAGGCTAGGCGTTT: AAACCAGGCTAGGCGTTTG
TAAACCTATACCCAGCACT: AAACCTATACCCAGCACTG
TAAAGCTAGTTCGCCGTAT: AAAGCTAGTTCGCCGTATA
TAACATGTAGACACGGCCA: AACATGTAGACACGGCCAT
TAACCAACATCAGAGCGCA: AACCAACATCAGAGCGCAG
TAACCTATACCCAGCACTG: AACCTATACCCAGCACTGG
TAACGCTGTAAGACAGCAC: AACGCTGTAAGACAGCACG
TAACGTAAACAGAAATTTC: AACGTAAACAGAAATTTCA
TAACGTTCTTCATTGTCCT: AACGTTCTTCATTGTCCTT
TAACTGAAAGGTACGTTCA: AACTGAAAGGTACGTTCAA
TAACTGAAGCGTTCACTTA: AACTGAAGCGTTCACTTAG
TAAGAAAAAGCCCAATATG: AAGAAAAAGCCCAATATGC
TAAGAAGAACGTACCAATG: AAGAAGAACGTACCAATGC
TAAGAATCGGGGAGACTAG: AAGAATCGGGGAGACTAGG
TAAGACAGCACGGACCAAT: AAGACAGCACGGACCAATG
TAAGATTTCGATCAGTCGA: AAGATTTCGATCAGTCGAG
TAAGCCTGCTCGCACGTTT: AAGCCTGCTCGCACGTTTT
TAAGGAATCTGGGCAACAC: AAGGAATCTGGGCAACACT
TAAGGGTTATCCGACCACG: AAGGGTTATCCGACCACGT
TAATAGTCCACTCTAATTC: AATAGTCCACTCTAATTCA
TAATATCGCGTCACATTCT: AATATCGCGTCACATTCTT
TAATCACCGTCTGATAAGG: AATCACCGTCTGATAAGGG
TAATCAGTTGAAAGTCGCT: AATCAGTTGAAAGTCGCTA
TAATTATGAGTCAAACCTA: AATTATGAGTCAAACCTAT
TAATTCAATCGGATCCTTC: AATTCAATCGGATCCTTCG
TAATTCAGAGCACGAAAAT: AATTCAGAGCACGAAAATT
TAATTTCTGACTGGTATCT: AATTTCTGACTGGTATCTA
TACAAGCTAGCCAATGTGT: ACAAGCTAGCCAATGTGTT
TACAAGGCGTGGTTTGCAG: ACAAGGCGTGGTTTGCAGA
TACAGTCAGCGCCCCGGAT: ACAGTCAGCGCCCCGGATC
TACATCATAGATGGCGTCT: ACATCATAGATGGCGTCTG
TACATGCGTCATTGATGAC: ACATGCGTCATTGATGACG
TACCAATGCCCTACCCGGT: ACCAATGCCCTACCCGGTA
TACCATGATGTTCGACCCC: ACCATGATGTTCGACCCCA
TACCCAGCACTGGATCAGT: ACCCAGCACTGGATCAGTC
TACCCAGCACTGGTCATTA: ACCCAGCACTGGTCATTAG
TACCCAGCACTGGTCTGGT: ACCCAGCACTGGTCTGGTG
TACCCAGCACTGGTTCCGT: ACCCAGCACTGGTTCCGTT
TACCCGGTATATCGTTAGA: ACCCGGTATATCGTTAGAG
TACCGTACGGGATGGGGTT: ACCGTACGGGATGGGGTTA
TACGAAAGCTGCGTAGACA: ACGAAAGCTGCGTAGACAA
TACGAGAAGGTTGGGAGTC: ACGAGAAGGTTGGGAGTCT
TACGCTTCTCGATCGCTGT: ACGCTTCTCGATCGCTGTC
TACGGGATGGGGTTATTTT: ACGGGATGGGGTTATTTTG
TACGTTCAAGTATGGGACA: ACGTTCAAGTATGGGACAC
TACTCTGTACTGGCATGCT: ACTCTGTACTGGCATGCTA
TACTGCGTGCAAGCATTTG: ACTGCGTGCAAGCATTTGG
TACTGGCATGCTAACTGAA: ACTGGCATGCTAACTGAAA
TACTTACATCATAGATGGC: ACTTACATCATAGATGGCG
TACTTCGCAGCCCGCGGAT: ACTTCGCAGCCCGCGGATC
TAGAACAGGACCTGTAGCT: AGAACAGGACCTGTAGCTA
TAGAAGTATACTCTGTACT: AGAAGTATACTCTGTACTG
TAGACAAATACTTACATCA: AGACAAATACTTACATCAT
TAGACACGGCCATCTCCTA: AGACACGGCCATCTCCTAG
TAGACCCGATGCCTGATCA: AGACCCGATGCCTGATCAC
TAGAGTCTAACGTTCTTCA: AGAGTCTAACGTTCTTCAT
TAGAGTGCAGCATTATCCT: AGAGTGCAGCATTATCCTG
TAGATAGTATCTGGAAATC: AGATAGTATCTGGAAATCA
TAGATCGGGAAGATGTAAC: AGATCGGGAAGATGTAACT
TAGATGGCGTCTGGTTGGT: AGATGGCGTCTGGTTGGTA
TAGATGTTGGAGCGCGAGA: AGATGTTGGAGCGCGAGAG
TAGCAAACTTTGTGTCAAT: AGCAAACTTTGTGTCAATC
TAGCCAATGTGTTGCGCGC: AGCCAATGTGTTGCGCGCA
TAGCCCGTAACGCTGTAAG: AGCCCGTAACGCTGTAAGA
TAGCGCCTCCTATCTTTTC: AGCGCCTCCTATCTTTTCT
TAGCTAGGGACGACGATGG: AGCTAGGGACGACGATGGT
TAGCTCGCAGTTTAATTCA: AGCTCGCAGTTTAATTCAG
TAGCTTTGAGATCGCTTGG: AGCTTTGAGATCGCTTGGC
TAGGAACAGTTAGATAGTA: AGGAACAGTTAGATAGTAT
TAGGCAACCATTTTTACTT: AGGCAACCATTTTTACTTC
TAGGCAGTCTTGGTCGCTT: AGGCAGTCTTGGTCGCTTA
TAGGCGTTTGTCCCTATGG: AGGCGTTTGTCCCTATGGA
TAGGCTAAGAAAAAGCCCA: AGGCTAAGAAAAAGCCCAA
TAGGCTTTTGAAGCAAAAT: AGGCTTTTGAAGCAAAATT
TAGGGACGACGATGGTATT: AGGGACGACGATGGTATTA
TAGGGCAGCTCACAATTAT: AGGGCAGCTCACAATTATC
TAGGGGCCGCTTAGTCATC: AGGGGCCGCTTAGTCATCG
TAGGGTAGGCAACCATTTT: AGGGTAGGCAACCATTTTT
TAGGGTCTGTGACAGCGAA: AGGGTCTGTGACAGCGAAG
TAGTAGCAAACTTTGTGTC: AGTAGCAAACTTTGTGTCA
TAGTATCTGGAAATCATCG: AGTATCTGGAAATCATCGG
TAGTCATCAACATGTCAGA: AGTCATCAACATGTCAGAA
TAGTCATCGCTGAGGTCCA: AGTCATCGCTGAGGTCCAT
TAGTCCACTCTAATTCAAT: AGTCCACTCTAATTCAATC
TAGTCGATGATCTAATAGT: AGTCGATGATCTAATAGTC
TAGTGTTTCAAAGAATTGC: AGTGTTTCAAAGAATTGCA
TAGTTCGCCGTATACAAGG: AGTTCGCCGTATACAAGGC
TAGTTGGCCCTATATAGCT: AGTTGGCCCTATATAGCTC
TATAAGATTTCGATCAGTC: ATAAGATTTCGATCAGTCG
TATACAAGGCGTGGTTTGC: ATACAAGGCGTGGTTTGCA
TATACCCAGCACTGGATCA: ATACCCAGCACTGGATCAG
TATACCCAGCACTGGTCAT: ATACCCAGCACTGGTCATT
TATACCCAGCACTGGTCTG: ATACCCAGCACTGGTCTGG
TATACCCAGCACTGGTTCC: ATACCCAGCACTGGTTCCG
TATACTCTGTACTGGCATG: ATACTCTGTACTGGCATGC
TATAGCCCGTAACGCTGTA: ATAGCCCGTAACGCTGTAA
TATAGCTCGCAGTTTAATT: ATAGCTCGCAGTTTAATTC
TATAGGGGCCGCTTAGTCA: ATAGGGGCCGCTTAGTCAT
TATAGTCGATGATCTAATA: ATAGTCGATGATCTAATAG
TATATAGCTCGCAGTTTAA: ATATAGCTCGCAGTTTAAT
TATATCGTTAGAGTCTAAC: ATATCGTTAGAGTCTAACG
TATCACCGCCTCGGACTCC: ATCACCGCCTCGGACTCCA
TATCCGACCACGTGGCGTA: ATCCGACCACGTGGCGTAG
TATCCTGAACCACTTTAGT: ATCCTGAACCACTTTAGTT
TATCGAACAGAGCTCATTC: ATCGAACAGAGCTCATTCT
TATCGCATGCGTGTTGAAA: ATCGCATGCGTGTTGAAAG
TATCGCGTCACATTCTTGA: ATCGCGTCACATTCTTGAA
TATCGTTAGAGTCTAACGT: ATCGTTAGAGTCTAACGTT
TATCGTTAGGGTCTGTGAC: ATCGTTAGGGTCTGTGACA
TATCTAGAAGTATACTCTG: ATCTAGAAGTATACTCTGT
TATCTCGAAACTTCGATGT: ATCTCGAAACTTCGATGTG
TATCTGGAAATCATCGGGC: ATCTGGAAATCATCGGGCG
TATCTTTTCTAGATGTTGG: ATCTTTTCTAGATGTTGGA
TATGAGTCAAACCTATCGC: ATGAGTCAAACCTATCGCA
TATGCGAGTGAGGTGTCCG: ATGCGAGTGAGGTGTCCGG
TATGGAATCTCGCTTTGGC: ATGGAATCTCGCTTTGGCT
TATGGGACACTTATAGGGG: ATGGGACACTTATAGGGGC
TATTAATCAGTTGAAAGTC: ATTAATCAGTTGAAAGTCG
TATTACATGCGTCATTGAT: ATTACATGCGTCATTGATG
TATTAGGGTAGGCAACCAT: ATTAGGGTAGGCAACCATT
TATTCCCAGTTGATTAGGA: ATTCCCAGTTGATTAGGAA
TATTGAAGCGGTAACATGT: ATTGAAGCGGTAACATGTA
TATTTTGCCCCACTTCCAT: ATTTTGCCCCACTTCCATC
TCAAACCTATCGCATGCGT: CAAACCTATCGCATGCGTG
TCAAAGAATTGCATGCGCT: CAAAGAATTGCATGCGCTG
TCAACATGTCAGAAAAGTA: CAACATGTCAGAAAAGTAA
TCAACTAGACCCGATGCCT: CAACTAGACCCGATGCCTG
TCAACTTGATGGTCGCCGC: CAACTTGATGGTCGCCGCG
TCAAGTATGGGACACTTAT: CAAGTATGGGACACTTATA
TCAATCCGCCCCGAGACAT: CAATCCGCCCCGAGACATA
TCAATCGGATCCTTCGCTG: CAATCGGATCCTTCGCTGG
TCACAAGTATAAGATTTCG: CACAAGTATAAGATTTCGA
TCACAATTATCACCGCCTC: CACAATTATCACCGCCTCG
TCACATTCTTGAATGATCG: CACATTCTTGAATGATCGT
TCACCGACTCTTGTGACCC: CACCGACTCTTGTGACCCC
TCACCGCCTCGGACTCCAG: CACCGCCTCGGACTCCAGC
TCACCGTCTGATAAGGGTT: CACCGTCTGATAAGGGTTA
TCACGCCACGAGTGAGCGA: CACGCCACGAGTGAGCGAT
TCACTTAAACCAGGCTAGG: CACTTAAACCAGGCTAGGC
TCACTTAGAGTGCAGCATT: CACTTAGAGTGCAGCATTA
TCAGAAAAGTAAGCCTGCT: CAGAAAAGTAAGCCTGCTC
TCAGAGCACGAAAATTGCT: CAGAGCACGAAAATTGCTT
TCAGAGCGCAGCTAAGAAG: CAGAGCGCAGCTAAGAAGA
TCAGATCATTGTCAGATTC: CAGATCATTGTCAGATTCC
TCAGATCTGACGTAGTCAT: CAGATCTGACGTAGTCATC
TCAGATTCCAGCGTTTAGG: CAGATTCCAGCGTTTAGGG
TCAGCGCCCCGGATCCGAT: CAGCGCCCCGGATCCGATC
TCAGGGTTCGCTCAACTAG: CAGGGTTCGCTCAACTAGA
TCAGTCAGGGTTCGCTCAA: CAGTCAGGGTTCGCTCAAC
TCAGTCCCCTCGATAATAT: CAGTCCCCTCGATAATATC
TCAGTCGAGTAACCAACAT: CAGTCGAGTAACCAACATC
TCAGTCTCGTTTGGGGTTG: CAGTCTCGTTTGGGGTTGC
TCAGTTGAAAGTCGCTATT: CAGTTGAAAGTCGCTATTA
TCATAGATGGCGTCTGGTT: CATAGATGGCGTCTGGTTG
TCATCAACATGTCAGAAAA: CATCAACATGTCAGAAAAG
TCATCGCTGAGGTCCATAC: CATCGCTGAGGTCCATACG
TCATCGGGCGTGTGCTGCA: CATCGGGCGTGTGCTGCAG
TCATTAGGCAGTCTTGGTC: CATTAGGCAGTCTTGGTCG
TCATTCTAACGTAAACAGA: CATTCTAACGTAAACAGAA
TCATTGATGACGATGTGCC: CATTGATGACGATGTGCCC
TCATTGTCAGATTCCAGCG: CATTGTCAGATTCCAGCGT
TCATTGTCCTTGCAGCAAT: CATTGTCCTTGCAGCAATT
TCCACTCCCAGTTCAACTT: CCACTCCCAGTTCAACTTG
TCCACTCTAATTCAATCGG: CCACTCTAATTCAATCGGA
TCCACTTGGTGCCGCTTCG: CCACTTGGTGCCGCTTCGT
TCCAGCAAGAGTCTGTGTA: CCAGCAAGAGTCTGTGTAT
TCCAGCGACGGTTTGGTTC: CCAGCGACGGTTTGGTTCT
TCCAGCGTGACATGGGTAG: CCAGCGTGACATGGGTAGA
TCCAGCGTTTAGGGCAGCT: CCAGCGTTTAGGGCAGCTC
TCCATACGAGAAGGTTGGG: CCATACGAGAAGGTTGGGA
TCCATCGACGAACAGCACC: CCATCGACGAACAGCACCT
TCCCACAGCGCTACAGTCA: CCCACAGCGCTACAGTCAG
TCCCAGTTCAACTTGATGG: CCCAGTTCAACTTGATGGT
TCCCAGTTGATTAGGAACA: CCCAGTTGATTAGGAACAG
TCCCCTCGATAATATCGCG: CCCCTCGATAATATCGCGT
TCCCTATGGAATCTCGCTT: CCCTATGGAATCTCGCTTT
TCCGACCACGTGGCGTAGC: CCGACCACGTGGCGTAGCG
TCCGATCGGGATACTGCGT: CCGATCGGGATACTGCGTG
TCCGATGTGCCCCACCTTT: CCGATGTGCCCCACCTTTG
TCCGCCCCGAGACATATTC: CCGCCCCGAGACATATTCC
TCCGGTTCGAACAGTATAG: CCGGTTCGAACAGTATAGT
TCCGTTACGAAAGCTGCGT: CCGTTACGAAAGCTGCGTA
TCCTAGTAGCAAACTTTGT: CCTAGTAGCAAACTTTGTG
TCCTATCGAACAGAGCTCA: CCTATCGAACAGAGCTCAT
TCCTATCTTTTCTAGATGT: CCTATCTTTTCTAGATGTT
TCCTCTCCGATGTGCCCCA: CCTCTCCGATGTGCCCCAC
TCCTGAACCACTTTAGTTG: CCTGAACCACTTTAGTTGG
TCCTGCGGGCTTCCTATCG: CCTGCGGGCTTCCTATCGA
TCCTTCGCTGGATGACCTT: CCTTCGCTGGATGACCTTG
TCCTTGCAGCAATTGTGTT: CCTTGCAGCAATTGTGTTT
TCGAAACTTCGATGTGCCC: CGAAACTTCGATGTGCCCC
TCGAACAGAGCTCATTCTA: CGAACAGAGCTCATTCTAA
TCGAACAGTATAGTCGATG: CGAACAGTATAGTCGATGA
TCGACCCCAATCGTCTCGC: CGACCCCAATCGTCTCGCG
TCGACGAACAGCACCTGGC: CGACGAACAGCACCTGGCA
TCGAGGAGGACCAAGGGGG: CGAGGAGGACCAAGGGGGC
TCGAGTAACCAACATCAGA: CGAGTAACCAACATCAGAG
TCGATAATATCGCGTCACA: CGATAATATCGCGTCACAT
TCGATCAGTCGAGTAACCA: CGATCAGTCGAGTAACCAA
TCGATCGCTGTCCTCTCCG: CGATCGCTGTCCTCTCCGA
TCGATGATCTAATAGTCCA: CGATGATCTAATAGTCCAC
TCGATGTGCCCCACCTTTG: CGATGTGCCCCACCTTTGT
TCGATTGAGCATATTGAAG: CGATTGAGCATATTGAAGC
TCGCAATGAAACCTATACC: CGCAATGAAACCTATACCC
TCGCACGTTTTGTCCAGCG: CGCACGTTTTGTCCAGCGT
TCGCAGCCCGCGGATCTAC: CGCAGCCCGCGGATCTACC
TCGCAGTTTAATTCAGAGC: CGCAGTTTAATTCAGAGCA
TCGCATGCGTGTTGAAAGT: CGCATGCGTGTTGAAAGTT
TCGCCGCGTAAAGCTAGTT: CGCCGCGTAAAGCTAGTTC
TCGCCGTATACAAGGCGTG: CGCCGTATACAAGGCGTGG
TCGCGTCACATTCTTGAAT: CGCGTCACATTCTTGAATG
TCGCGTGGGGCGGGTCGGG: CGCGTGGGGCGGGTCGGGC
TCGCTATTAGGGTAGGCAA: CGCTATTAGGGTAGGCAAC
TCGCTCAACTAGACCCGAT: CGCTCAACTAGACCCGATG
TCGCTGAGGTCCATACGAG: CGCTGAGGTCCATACGAGA
TCGCTGGATGACCTTGAGG: CGCTGGATGACCTTGAGGA
TCGCTGTCCTCTCCGATGT: CGCTGTCCTCTCCGATGTG
TCGCTTAGGCTAAGAAAAA: CGCTTAGGCTAAGAAAAAG
TCGCTTGGCTTCAGTCCCC: CGCTTGGCTTCAGTCCCCT
TCGCTTTGGCTAATTTCTG: CGCTTTGGCTAATTTCTGA
TCGGAAATCCTGCGGGCTT: CGGAAATCCTGCGGGCTTC
TCGGACTCCAGCGACGGTT: CGGACTCCAGCGACGGTTT
TCGGATCCTTCGCTGGATG: CGGATCCTTCGCTGGATGA
TCGGATCTGCCCCAGCTCC: CGGATCTGCCCCAGCTCCA
TCGGCGAATGATAAGAATC: CGGCGAATGATAAGAATCG
TCGGGAAGATGTAACTGAA: CGGGAAGATGTAACTGAAG
TCGGGACTTTAACCTATAC: CGGGACTTTAACCTATACC
TCGGGATACTGCGTGCAAG: CGGGATACTGCGTGCAAGC
TCGGGCCCGGGTTCCACTC: CGGGCCCGGGTTCCACTCC
TCGGGCGTGTGCTGCAGAG: CGGGCGTGTGCTGCAGAGT
TCGGGGAGACTAGGCTTTT: CGGGGAGACTAGGCTTTTG
TCGTAGCTTTGAGATCGCT: CGTAGCTTTGAGATCGCTT
TCGTCTCGCGTGGGGCGGG: CGTCTCGCGTGGGGCGGGT
TCGTGTATCGTTAGGGTCT: CGTGTATCGTTAGGGTCTG
TCGTTAGAGTCTAACGTTC: CGTTAGAGTCTAACGTTCT
TCGTTAGGGTCTGTGACAG: CGTTAGGGTCTGTGACAGC
TCGTTTGGGGTTGCTGACC: CGTTTGGGGTTGCTGACCT
TCTAACGTAAACAGAAATT: CTAACGTAAACAGAAATTT
TCTAACGTTCTTCATTGTC: CTAACGTTCTTCATTGTCC
TCTAATAGTCCACTCTAAT: CTAATAGTCCACTCTAATT
TCTAATTCAATCGGATCCT: CTAATTCAATCGGATCCTT
TCTACCGTACGGGATGGGG: CTACCGTACGGGATGGGGT
TCTAGAAGTATACTCTGTA: CTAGAAGTATACTCTGTAC
TCTAGATGTTGGAGCGCGA: CTAGATGTTGGAGCGCGAG
TCTCACAAGTATAAGATTT: CTCACAAGTATAAGATTTC
TCTCACCGACTCTTGTGAC: CTCACCGACTCTTGTGACC
TCTCAGTCAGGGTTCGCTC: CTCAGTCAGGGTTCGCTCA
TCTCCGATGTGCCCCACCT: CTCCGATGTGCCCCACCTT
TCTCCTAGTAGCAAACTTT: CTCCTAGTAGCAAACTTTG
TCTCGAAACTTCGATGTGC: CTCGAAACTTCGATGTGCC
TCTCGATCGCTGTCCTCTC: CTCGATCGCTGTCCTCTCC
TCTCGCGTGGGGCGGGTCG: CTCGCGTGGGGCGGGTCGG
TCTCGCTTTGGCTAATTTC: CTCGCTTTGGCTAATTTCT
TCTCGTTTGGGGTTGCTGA: CTCGTTTGGGGTTGCTGAC
TCTCTCACCGACTCTTGTG: CTCTCACCGACTCTTGTGA
TCTGACGTAGTCATCAACA: CTGACGTAGTCATCAACAT
TCTGACTGGTATCTAGAAG: CTGACTGGTATCTAGAAGT
TCTGATAAGGGTTATCCGA: CTGATAAGGGTTATCCGAC
TCTGCCCCAGCTCCACTTG: CTGCCCCAGCTCCACTTGG
TCTGGAAATCATCGGGCGT: CTGGAAATCATCGGGCGTG
TCTGGGCAACACTTGCAGA: CTGGGCAACACTTGCAGAT
TCTGGTGAAATACAAGCTA: CTGGTGAAATACAAGCTAG
TCTGGTTGGTATAGCCCGT: CTGGTTGGTATAGCCCGTA
TCTGTACTGGCATGCTAAC: CTGTACTGGCATGCTAACT
TCTGTGACAGCGAAGCAAT: CTGTGACAGCGAAGCAATA
TCTGTGTATTAATCAGTTG: CTGTGTATTAATCAGTTGA
TCTTCATTGTCCTTGCAGC: CTTCATTGTCCTTGCAGCA
TCTTGAATGATCGTGTATC: CTTGAATGATCGTGTATCG
TCTTGGTCGCTTAGGCTAA: CTTGGTCGCTTAGGCTAAG
TCTTGTGACCCCATAAGGA: CTTGTGACCCCATAAGGAA
TCTTTTCTAGATGTTGGAG: CTTTTCTAGATGTTGGAGC
TGAAACCTATACCCAGCAC: GAAACCTATACCCAGCACT
TGAAAGGTACGTTCAAGTA: GAAAGGTACGTTCAAGTAT
TGAAAGTCGCTATTAGGGT: GAAAGTCGCTATTAGGGTA
TGAAAGTTGAGCAACCCGC: GAAAGTTGAGCAACCCGCG
TGAAATACAAGCTAGCCAA: GAAATACAAGCTAGCCAAT
TGAAATGTCGGAAATCCTG: GAAATGTCGGAAATCCTGC
TGAACCACTTTAGTTGGCC: GAACCACTTTAGTTGGCCC
TGAAGCAAAATTGACTCGA: GAAGCAAAATTGACTCGAT
TGAAGCGGTAACATGTAGA: GAAGCGGTAACATGTAGAC
TGAAGCGTTCACTTAGAGT: GAAGCGTTCACTTAGAGTG
TGAATGATCGTGTATCGTT: GAATGATCGTGTATCGTTA
TGACAGCGAAGCAATAGAT: GACAGCGAAGCAATAGATC
TGACATGGGTAGAACAGGA: GACATGGGTAGAACAGGAC
TGACCCCATAAGGAATCTG: GACCCCATAAGGAATCTGG
TGACCTTATTACATGCGTC: GACCTTATTACATGCGTCA
TGACCTTGAGGAGCTTACC: GACCTTGAGGAGCTTACCA
TGACGATGTGCCCCACCTT: GACGATGTGCCCCACCTTT
TGACGTAGTCATCAACATG: GACGTAGTCATCAACATGT
TGACTCGATTGAGCATATT: GACTCGATTGAGCATATTG
TGACTGGTATCTAGAAGTA: GACTGGTATCTAGAAGTAT
TGAGAACGTCACTTAAACC: GAGAACGTCACTTAAACCA
TGAGATCGCTTGGCTTCAG: GAGATCGCTTGGCTTCAGT
TGAGCAACCCGCGCTCAGA: GAGCAACCCGCGCTCAGAT
TGAGCATATTGAAGCGGTA: GAGCATATTGAAGCGGTAA
TGAGCGATGTGCCCCACCT: GAGCGATGTGCCCCACCTT
TGAGGAGCTTACCATGATG: GAGGAGCTTACCATGATGT
TGAGGGTGAGTAGTGTTTC: GAGGGTGAGTAGTGTTTCA
TGAGGTCCATACGAGAAGG: GAGGTCCATACGAGAAGGT
TGAGGTGTCCGGTTCGAAC: GAGGTGTCCGGTTCGAACA
TGAGTAGTGTTTCAAAGAA: GAGTAGTGTTTCAAAGAAT
TGAGTCAAACCTATCGCAT: GAGTCAAACCTATCGCATG
TGATAAGAATCGGGGAGAC: GATAAGAATCGGGGAGACT
TGATAAGGGTTATCCGACC: GATAAGGGTTATCCGACCA
TGATCACGCCACGAGTGAG: GATCACGCCACGAGTGAGC
TGATCGTGTATCGTTAGGG: GATCGTGTATCGTTAGGGT
TGATCTAATAGTCCACTCT: GATCTAATAGTCCACTCTA
TGATGACGATGTGCCCCAC: GATGACGATGTGCCCCACC
TGATGGTCGCCGCGTAAAG: GATGGTCGCCGCGTAAAGC
TGATGTTCGACCCCAATCG: GATGTTCGACCCCAATCGT
TGATTAGGAACAGTTAGAT: GATTAGGAACAGTTAGATA
TGATTCGCAATGAAACCTA: GATTCGCAATGAAACCTAT
TGCAAGCATTTGGTGAGGG: GCAAGCATTTGGTGAGGGT
TGCACCTGTATCTCGAAAC: GCACCTGTATCTCGAAACT
TGCAGAATGGCACTTACGC: GCAGAATGGCACTTACGCT
TGCAGAGTCCCACAGCGCT: GCAGAGTCCCACAGCGCTA
TGCAGATAATTATGAGTCA: GCAGATAATTATGAGTCAA
TGCAGCAATTGTGTTTCTC: GCAGCAATTGTGTTTCTCA
TGCAGCATTATCCTGAACC: GCAGCATTATCCTGAACCA
TGCATGCGCTGAAATGTCG: GCATGCGCTGAAATGTCGG
TGCCCCACCTTTGATTCGC: GCCCCACCTTTGATTCGCA
TGCCCCACCTTTGCGCTGC: GCCCCACCTTTGCGCTGCG
TGCCCCACCTTTGGACTGG: GCCCCACCTTTGGACTGGG
TGCCCCACCTTTGTTCGGG: GCCCCACCTTTGTTCGGGA
TGCCCCACTTCCATCGACG: GCCCCACTTCCATCGACGA
TGCCCCAGCTCCACTTGGT: GCCCCAGCTCCACTTGGTG
TGCCCTACCCGGTATATCG: GCCCTACCCGGTATATCGT
TGCCGCTTCGTAGCTTTGA: GCCGCTTCGTAGCTTTGAG
TGCCTGATCACGCCACGAG: GCCTGATCACGCCACGAGT
TGCGAGTGAGGTGTCCGGT: GCGAGTGAGGTGTCCGGTT
TGCGCAAGAACCTATACCC: GCGCAAGAACCTATACCCA
TGCGCGCACCGTTCGGATC: GCGCGCACCGTTCGGATCT
TGCGCTGAAATGTCGGAAA: GCGCTGAAATGTCGGAAAT
TGCGCTGCGCAAGAACCTA: GCGCTGCGCAAGAACCTAT
TGCGGGCTTCCTATCGAAC: GCGGGCTTCCTATCGAACA
TGCGTAGACAAATACTTAC: GCGTAGACAAATACTTACA
TGCGTCATTGATGACGATG: GCGTCATTGATGACGATGT
TGCGTGCAAGCATTTGGTG: GCGTGCAAGCATTTGGTGA
TGCGTGTTGAAAGTTGAGC: GCGTGTTGAAAGTTGAGCA
TGCTAACTGAAAGGTACGT: GCTAACTGAAAGGTACGTT
TGCTCGCACGTTTTGTCCA: GCTCGCACGTTTTGTCCAG
TGCTGACCTTATTACATGC: GCTGACCTTATTACATGCG
TGCTGCAGAGTCCCACAGC: GCTGCAGAGTCCCACAGCG
TGCTTCGAGGAGGACCAAG: GCTTCGAGGAGGACCAAGG
TGGAAATCATCGGGCGTGT: GGAAATCATCGGGCGTGTG
TGGAATCTCGCTTTGGCTA: GGAATCTCGCTTTGGCTAA
TGGACTGGGCGTAAACCTA: GGACTGGGCGTAAACCTAT
TGGAGCGCGAGAGGCAACG: GGAGCGCGAGAGGCAACGA
TGGATCAGTCTCGTTTGGG: GGATCAGTCTCGTTTGGGG
TGGATGACCTTGAGGAGCT: GGATGACCTTGAGGAGCTT
TGGCAAATTTGAGAACGTC: GGCAAATTTGAGAACGTCA
TGGCACTTACGCTTCTCGA: GGCACTTACGCTTCTCGAT
TGGCATGCTAACTGAAAGG: GGCATGCTAACTGAAAGGT
TGGCCCTATATAGCTCGCA: GGCCCTATATAGCTCGCAG
TGGCGTAGCGCCTCCTATC: GGCGTAGCGCCTCCTATCT
TGGCGTCTGGTTGGTATAG: GGCGTCTGGTTGGTATAGC
TGGCTAATTTCTGACTGGT: GGCTAATTTCTGACTGGTA
TGGCTTCAGTCCCCTCGAT: GGCTTCAGTCCCCTCGATA
TGGGACACTTATAGGGGCC: GGGACACTTATAGGGGCCG
TGGGAGTCTCACAAGTATA: GGGAGTCTCACAAGTATAA
TGGGCAACACTTGCAGATA: GGGCAACACTTGCAGATAA
TGGGCGTAAACCTATACCC: GGGCGTAAACCTATACCCA
TGGGGCGGGTCGGGCCCGG: GGGGCGGGTCGGGCCCGGG
TGGGGTTATTTTGCCCCAC: GGGGTTATTTTGCCCCACT
TGGGGTTGCTGACCTTATT: GGGGTTGCTGACCTTATTA
TGGGTAGAACAGGACCTGT: GGGTAGAACAGGACCTGTA
TGGTATAGCCCGTAACGCT: GGTATAGCCCGTAACGCTG
TGGTATCTAGAAGTATACT: GGTATCTAGAAGTATACTC
TGGTCATTAGGCAGTCTTG: GGTCATTAGGCAGTCTTGG
TGGTCGCCGCGTAAAGCTA: GGTCGCCGCGTAAAGCTAG
TGGTCGCTTAGGCTAAGAA: GGTCGCTTAGGCTAAGAAA
TGGTCTGGTGAAATACAAG: GGTCTGGTGAAATACAAGC
TGGTGAAATACAAGCTAGC: GGTGAAATACAAGCTAGCC
TGGTGAGGGTGAGTAGTGT: GGTGAGGGTGAGTAGTGTT
TGGTGCACCTGTATCTCGA: GGTGCACCTGTATCTCGAA
TGGTGCCGCTTCGTAGCTT: GGTGCCGCTTCGTAGCTTT
TGGTTCCGTTACGAAAGCT: GGTTCCGTTACGAAAGCTG
TGGTTCTCTCACCGACTCT: GGTTCTCTCACCGACTCTT
TGGTTGGTATAGCCCGTAA: GGTTGGTATAGCCCGTAAC
TGGTTTGCAGAATGGCACT: GGTTTGCAGAATGGCACTT
TGTAACTGAAGCGTTCACT: GTAACTGAAGCGTTCACTT
TGTAAGACAGCACGGACCA: GTAAGACAGCACGGACCAA
TGTACTGGCATGCTAACTG: GTACTGGCATGCTAACTGA
TGTAGACACGGCCATCTCC: GTAGACACGGCCATCTCCT
TGTAGCTAGGGACGACGAT: GTAGCTAGGGACGACGATG
TGTATCGTTAGGGTCTGTG: GTATCGTTAGGGTCTGTGA
TGTATCTCGAAACTTCGAT: GTATCTCGAAACTTCGATG
TGTATTAATCAGTTGAAAG: GTATTAATCAGTTGAAAGT
TGTCAATCCGCCCCGAGAC: GTCAATCCGCCCCGAGACA
TGTCAGAAAAGTAAGCCTG: GTCAGAAAAGTAAGCCTGC
TGTCAGATTCCAGCGTTTA: GTCAGATTCCAGCGTTTAG
TGTCCAGCGTGACATGGGT: GTCCAGCGTGACATGGGTA
TGTCCCTATGGAATCTCGC: GTCCCTATGGAATCTCGCT
TGTCCGGTTCGAACAGTAT: GTCCGGTTCGAACAGTATA
TGTCCTCTCCGATGTGCCC: GTCCTCTCCGATGTGCCCC
TGTCCTTGCAGCAATTGTG: GTCCTTGCAGCAATTGTGT
TGTCGGAAATCCTGCGGGC: GTCGGAAATCCTGCGGGCT
TGTGACAGCGAAGCAATAG: GTGACAGCGAAGCAATAGA
TGTGACCCCATAAGGAATC: GTGACCCCATAAGGAATCT
TGTGCCCCACCTTTGATTC: GTGCCCCACCTTTGATTCG
TGTGCCCCACCTTTGCGCT: GTGCCCCACCTTTGCGCTG
TGTGCCCCACCTTTGGACT: GTGCCCCACCTTTGGACTG
TGTGCCCCACCTTTGTTCG: GTGCCCCACCTTTGTTCGG
TGTGCTGCAGAGTCCCACA: GTGCTGCAGAGTCCCACAG
TGTGTATTAATCAGTTGAA: GTGTATTAATCAGTTGAAA
TGTGTCAATCCGCCCCGAG: GTGTCAATCCGCCCCGAGA
TGTGTTGCGCGCACCGTTC: GTGTTGCGCGCACCGTTCG
TGTGTTTCTCAGTCAGGGT: GTGTTTCTCAGTCAGGGTT
TGTTCGACCCCAATCGTCT: GTTCGACCCCAATCGTCTC
TGTTCGGGACTTTAACCTA: GTTCGGGACTTTAACCTAT
TGTTGAAAGTTGAGCAACC: GTTGAAAGTTGAGCAACCC
TGTTGCGCGCACCGTTCGG: GTTGCGCGCACCGTTCGGA
TGTTGGAGCGCGAGAGGCA: GTTGGAGCGCGAGAGGCAA
TGTTTCAAAGAATTGCATG: GTTTCAAAGAATTGCATGC
TGTTTCGGCGAATGATAAG: GTTTCGGCGAATGATAAGA
TGTTTCTCAGTCAGGGTTC: GTTTCTCAGTCAGGGTTCG
TTAAACCAGGCTAGGCGTT: TAAACCAGGCTAGGCGTTT
TTAACCTATACCCAGCACT: TAACCTATACCCAGCACTG
TTAATCAGTTGAAAGTCGC: TAATCAGTTGAAAGTCGCT
TTAATTCAGAGCACGAAAA: TAATTCAGAGCACGAAAAT
TTACATCATAGATGGCGTC: TACATCATAGATGGCGTCT
TTACATGCGTCATTGATGA: TACATGCGTCATTGATGAC
TTACCATGATGTTCGACCC: TACCATGATGTTCGACCCC
TTACGAAAGCTGCGTAGAC: TACGAAAGCTGCGTAGACA
TTACGCTTCTCGATCGCTG: TACGCTTCTCGATCGCTGT
TTACTTCGCAGCCCGCGGA: TACTTCGCAGCCCGCGGAT
TTAGAGTCTAACGTTCTTC: TAGAGTCTAACGTTCTTCA
TTAGAGTGCAGCATTATCC: TAGAGTGCAGCATTATCCT
TTAGATAGTATCTGGAAAT: TAGATAGTATCTGGAAATC
TTAGGAACAGTTAGATAGT: TAGGAACAGTTAGATAGTA
TTAGGCAGTCTTGGTCGCT: TAGGCAGTCTTGGTCGCTT
TTAGGCTAAGAAAAAGCCC: TAGGCTAAGAAAAAGCCCA
TTAGGGCAGCTCACAATTA: TAGGGCAGCTCACAATTAT
TTAGGGTAGGCAACCATTT: TAGGGTAGGCAACCATTTT
TTAGGGTCTGTGACAGCGA: TAGGGTCTGTGACAGCGAA
TTAGTCATCGCTGAGGTCC: TAGTCATCGCTGAGGTCCA
TTAGTTGGCCCTATATAGC: TAGTTGGCCCTATATAGCT
TTATAGGGGCCGCTTAGTC: TATAGGGGCCGCTTAGTCA
TTATCACCGCCTCGGACTC: TATCACCGCCTCGGACTCC
TTATCCGACCACGTGGCGT: TATCCGACCACGTGGCGTA
TTATCCTGAACCACTTTAG: TATCCTGAACCACTTTAGT
TTATGAGTCAAACCTATCG: TATGAGTCAAACCTATCGC
TTATTACATGCGTCATTGA: TATTACATGCGTCATTGAT
TTATTTTGCCCCACTTCCA: TATTTTGCCCCACTTCCAT
TTCAAAGAATTGCATGCGC: TCAAAGAATTGCATGCGCT
TTCAACTTGATGGTCGCCG: TCAACTTGATGGTCGCCGC
TTCAAGTATGGGACACTTA: TCAAGTATGGGACACTTAT
TTCAATCGGATCCTTCGCT: TCAATCGGATCCTTCGCTG
TTCACTTAGAGTGCAGCAT: TCACTTAGAGTGCAGCATT
TTCAGAGCACGAAAATTGC: TCAGAGCACGAAAATTGCT
TTCAGATCATTGTCAGATT: TCAGATCATTGTCAGATTC
TTCAGTCCCCTCGATAATA: TCAGTCCCCTCGATAATAT
TTCATTGTCCTTGCAGCAA: TCATTGTCCTTGCAGCAAT
TTCCACTCCCAGTTCAACT: TCCACTCCCAGTTCAACTT
TTCCAGCAAGAGTCTGTGT: TCCAGCAAGAGTCTGTGTA
TTCCAGCGTTTAGGGCAGC: TCCAGCGTTTAGGGCAGCT
TTCCATCGACGAACAGCAC: TCCATCGACGAACAGCACC
TTCCCAGTTGATTAGGAAC: TCCCAGTTGATTAGGAACA
TTCCGTTACGAAAGCTGCG: TCCGTTACGAAAGCTGCGT
TTCCTATCGAACAGAGCTC: TCCTATCGAACAGAGCTCA
TTCGAACAGTATAGTCGAT: TCGAACAGTATAGTCGATG
TTCGACCCCAATCGTCTCG: TCGACCCCAATCGTCTCGC
TTCGAGGAGGACCAAGGGG: TCGAGGAGGACCAAGGGGG
TTCGATCAGTCGAGTAACC: TCGATCAGTCGAGTAACCA
TTCGATGTGCCCCACCTTT: TCGATGTGCCCCACCTTTG
TTCGCAATGAAACCTATAC: TCGCAATGAAACCTATACC
TTCGCAGCCCGCGGATCTA: TCGCAGCCCGCGGATCTAC
TTCGCCGTATACAAGGCGT: TCGCCGTATACAAGGCGTG
TTCGCTCAACTAGACCCGA: TCGCTCAACTAGACCCGAT
TTCGCTGGATGACCTTGAG: TCGCTGGATGACCTTGAGG
TTCGGATCTGCCCCAGCTC: TCGGATCTGCCCCAGCTCC
TTCGGCGAATGATAAGAAT: TCGGCGAATGATAAGAATC
TTCGGGACTTTAACCTATA: TCGGGACTTTAACCTATAC
TTCGTAGCTTTGAGATCGC: TCGTAGCTTTGAGATCGCT
TTCTAACGTAAACAGAAAT: TCTAACGTAAACAGAAATT
TTCTAGATGTTGGAGCGCG: TCTAGATGTTGGAGCGCGA
TTCTCAGTCAGGGTTCGCT: TCTCAGTCAGGGTTCGCTC
TTCTCGATCGCTGTCCTCT: TCTCGATCGCTGTCCTCTC
TTCTCTCACCGACTCTTGT: TCTCTCACCGACTCTTGTG
TTCTGACTGGTATCTAGAA: TCTGACTGGTATCTAGAAG
TTCTTCATTGTCCTTGCAG: TCTTCATTGTCCTTGCAGC
TTCTTGAATGATCGTGTAT: TCTTGAATGATCGTGTATC
TTGAAAGTCGCTATTAGGG: TGAAAGTCGCTATTAGGGT
TTGAAAGTTGAGCAACCCG: TGAAAGTTGAGCAACCCGC
TTGAAGCAAAATTGACTCG: TGAAGCAAAATTGACTCGA
TTGAAGCGGTAACATGTAG: TGAAGCGGTAACATGTAGA
TTGAATGATCGTGTATCGT: TGAATGATCGTGTATCGTT
TTGACTCGATTGAGCATAT: TGACTCGATTGAGCATATT
TTGAGAACGTCACTTAAAC: TGAGAACGTCACTTAAACC
TTGAGATCGCTTGGCTTCA: TGAGATCGCTTGGCTTCAG
TTGAGCAACCCGCGCTCAG: TGAGCAACCCGCGCTCAGA
TTGAGCATATTGAAGCGGT: TGAGCATATTGAAGCGGTA
TTGAGGAGCTTACCATGAT: TGAGGAGCTTACCATGATG
TTGATGACGATGTGCCCCA: TGATGACGATGTGCCCCAC
TTGATGGTCGCCGCGTAAA: TGATGGTCGCCGCGTAAAG
TTGATTAGGAACAGTTAGA: TGATTAGGAACAGTTAGAT
TTGATTCGCAATGAAACCT: TGATTCGCAATGAAACCTA
TTGCAGAATGGCACTTACG: TGCAGAATGGCACTTACGC
TTGCAGATAATTATGAGTC: TGCAGATAATTATGAGTCA
TTGCAGCAATTGTGTTTCT: TGCAGCAATTGTGTTTCTC
TTGCATGCGCTGAAATGTC: TGCATGCGCTGAAATGTCG
TTGCCCCACTTCCATCGAC: TGCCCCACTTCCATCGACG
TTGCGCGCACCGTTCGGAT: TGCGCGCACCGTTCGGATC
TTGCGCTGCGCAAGAACCT: TGCGCTGCGCAAGAACCTA
TTGCTGACCTTATTACATG: TGCTGACCTTATTACATGC
TTGCTTCGAGGAGGACCAA: TGCTTCGAGGAGGACCAAG
TTGGACTGGGCGTAAACCT: TGGACTGGGCGTAAACCTA
TTGGAGCGCGAGAGGCAAC: TGGAGCGCGAGAGGCAACG
TTGGCCCTATATAGCTCGC: TGGCCCTATATAGCTCGCA
TTGGCTAATTTCTGACTGG: TGGCTAATTTCTGACTGGT
TTGGCTTCAGTCCCCTCGA: TGGCTTCAGTCCCCTCGAT
TTGGGAGTCTCACAAGTAT: TGGGAGTCTCACAAGTATA
TTGGGGTTGCTGACCTTAT: TGGGGTTGCTGACCTTATT
TTGGTATAGCCCGTAACGC: TGGTATAGCCCGTAACGCT
TTGGTCGCTTAGGCTAAGA: TGGTCGCTTAGGCTAAGAA
TTGGTGAGGGTGAGTAGTG: TGGTGAGGGTGAGTAGTGT
TTGGTGCACCTGTATCTCG: TGGTGCACCTGTATCTCGA
TTGGTGCCGCTTCGTAGCT: TGGTGCCGCTTCGTAGCTT
TTGGTTCTCTCACCGACTC: TGGTTCTCTCACCGACTCT
TTGTCAGATTCCAGCGTTT: TGTCAGATTCCAGCGTTTA
TTGTCCAGCGTGACATGGG: TGTCCAGCGTGACATGGGT
TTGTCCCTATGGAATCTCG: TGTCCCTATGGAATCTCGC
TTGTCCTTGCAGCAATTGT: TGTCCTTGCAGCAATTGTG
TTGTGACCCCATAAGGAAT: TGTGACCCCATAAGGAATC
TTGTGTCAATCCGCCCCGA: TGTGTCAATCCGCCCCGAG
TTGTGTTTCTCAGTCAGGG: TGTGTTTCTCAGTCAGGGT
TTGTTCGGGACTTTAACCT: TGTTCGGGACTTTAACCTA
TTTAACCTATACCCAGCAC: TTAACCTATACCCAGCACT
TTTAATTCAGAGCACGAAA: TTAATTCAGAGCACGAAAA
TTTACTTCGCAGCCCGCGG: TTACTTCGCAGCCCGCGGA
TTTAGGGCAGCTCACAATT: TTAGGGCAGCTCACAATTA
TTTAGTTGGCCCTATATAG: TTAGTTGGCCCTATATAGC
TTTCAAAGAATTGCATGCG: TTCAAAGAATTGCATGCGC
TTTCAGATCATTGTCAGAT: TTCAGATCATTGTCAGATT
TTTCCAGCAAGAGTCTGTG: TTCCAGCAAGAGTCTGTGT
TTTCGATCAGTCGAGTAAC: TTCGATCAGTCGAGTAACC
TTTCGGCGAATGATAAGAA: TTCGGCGAATGATAAGAAT
TTTCTAGATGTTGGAGCGC: TTCTAGATGTTGGAGCGCG
TTTCTCAGTCAGGGTTCGC: TTCTCAGTCAGGGTTCGCT
TTTCTGACTGGTATCTAGA: TTCTGACTGGTATCTAGAA
TTTGAAGCAAAATTGACTC: TTGAAGCAAAATTGACTCG
TTTGAGAACGTCACTTAAA: TTGAGAACGTCACTTAAAC
TTTGAGATCGCTTGGCTTC: TTGAGATCGCTTGGCTTCA
TTTGATTCGCAATGAAACC: TTGATTCGCAATGAAACCT
TTTGCAGAATGGCACTTAC: TTGCAGAATGGCACTTACG
TTTGCCCCACTTCCATCGA: TTGCCCCACTTCCATCGAC
TTTGCGCTGCGCAAGAACC: TTGCGCTGCGCAAGAACCT
TTTGGACTGGGCGTAAACC: TTGGACTGGGCGTAAACCT
TTTGGCTAATTTCTGACTG: TTGGCTAATTTCTGACTGG
TTTGGGGTTGCTGACCTTA: TTGGGGTTGCTGACCTTAT
TTTGGTGAGGGTGAGTAGT: TTGGTGAGGGTGAGTAGTG
TTTGGTTCTCTCACCGACT: TTGGTTCTCTCACCGACTC
TTTGTCCAGCGTGACATGG: TTGTCCAGCGTGACATGGG
TTTGTCCCTATGGAATCTC: TTGTCCCTATGGAATCTCG
TTTGTGTCAATCCGCCCCG: TTGTGTCAATCCGCCCCGA
TTTGTTCGGGACTTTAACC: TTGTTCGGGACTTTAACCT
TTTTACTTCGCAGCCCGCG: TTTACTTCGCAGCCCGCGG
TTTTCCAGCAAGAGTCTGT: TTTCCAGCAAGAGTCTGTG
TTTTCTAGATGTTGGAGCG: TTTCTAGATGTTGGAGCGC
TTTTGAAGCAAAATTGACT: TTTGAAGCAAAATTGACTC
TTTTGCCCCACTTCCATCG: TTTGCCCCACTTCCATCGA
TTTTGTCCAGCGTGACATG: TTTGTCCAGCGTGACATGG
TTTTTACTTCGCAGCCCGC: TTTTACTTCGCAGCCCGCG